A   ->   n
a   ->   n
Ab   ->   no
aba   ->   non
Abba   ->   noon
Abe   ->   nor
abjurer   ->   nowhere
Abo   ->   nob
Ah   ->   nu
ah   ->   nu
aha   ->   nun
aho   ->   nub
an   ->   na
Ana   ->   nan
ana   ->   nan
anan   ->   nana
anil   ->   navy
Ann   ->   naa
ann   ->   naa
ant   ->   nag
ar   ->   ne
arba   ->   neon
arc   ->   nep
arn   ->   nea
Arne   ->   near
Aro   ->   neb
Avar   ->   nine
avo   ->   nib
B   ->   o
b   ->   o
ba   ->   on
balk   ->   onyx
Ban   ->   ona
ban   ->   ona
bar   ->   one
Bare   ->   oner
bare   ->   oner
be   ->   or
bean   ->   orna
becuna   ->   orphan
beg   ->   ort
Bel   ->   ory
bel   ->   ory
Ben   ->   ora
ben   ->   ora
ber   ->   ore
bes   ->   orf
bin   ->   ova
birl   ->   ovey
bor   ->   obe
Brava   ->   oenin
Bu   ->   oh
bu   ->   oh
bub   ->   oho
C   ->   p
c   ->   p
cha   ->   pun
chal   ->   puny
chat   ->   pung
che   ->   pur
Chechen   ->   purpura
chee   ->   purr
cheer   ->   purre
cheery   ->   purrel
cho   ->   pub
clerk   ->   pyrex
crag   ->   pent
Crax   ->   penk
crea   ->   pern
creel   ->   perry
Crex   ->   perk
cub   ->   pho
Cuba   ->   phon
D   ->   q
d   ->   q
dhoon   ->   qubba
E   ->   r
e   ->   r
en   ->   ra
envy   ->   rail
er   ->   re
Erava   ->   renin
erg   ->   ret
erne   ->   rear
err   ->   ree
ers   ->   ref
F   ->   s
f   ->   s
fant   ->   snag
faro   ->   sneb
flap   ->   sync
fra   ->   sen
freir   ->   serve
fu   ->   sh
fub   ->   sho
fubby   ->   shool
fun   ->   sha
funt   ->   shag
Fur   ->   she
fur   ->   she
G   ->   t
g   ->   t
gel   ->   try
gen   ->   tra
gent   ->   trag
genu   ->   trah
gers   ->   tref
Ghan   ->   tuna
ghat   ->   tung
ghee   ->   turr
gnar   ->   tane
gnat   ->   tang
gra   ->   ten
grat   ->   teng
greeny   ->   terral
grr   ->   tee
gul   ->   thy
gun   ->   tha
guna   ->   than
gunj   ->   thaw
gur   ->   the
gurl   ->   they
gurr   ->   thee
H   ->   u
h   ->   u
ha   ->   un
he   ->   ur
Hein   ->   urva
hen   ->   ura
her   ->   ure
hern   ->   urea
hin   ->   uva
I   ->   v
i   ->   v
Ing   ->   vat
ing   ->   vat
Iraq   ->   vend
irk   ->   vex
Ivan   ->   vina
ivin   ->   viva
J   ->   w
j   ->   w
Juha   ->   whun
Jun   ->   wha
June   ->   whar
june   ->   whar
Jura   ->   when
K   ->   x
k   ->   x
L   ->   y
l   ->   y
la   ->   yn
M   ->   z
m   ->   z
N   ->   a
n   ->   a
na   ->   an
naa   ->   ann
nag   ->   ant
Nan   ->   ana
nan   ->   ana
Nana   ->   anan
nana   ->   anan
navy   ->   anil
ne   ->   ar
nea   ->   arn
neon   ->   arba
Nep   ->   arc
nep   ->   arc
nib   ->   avo
non   ->   aba
nowhere   ->   abjurer
nu   ->   ah
nub   ->   aho
nun   ->   aha
O   ->   b
o   ->   b
obe   ->   bor
oh   ->   bu
oho   ->   bub
on   ->   ba
Ona   ->   ban
ona   ->   ban
one   ->   bar
oner   ->   bare
onyx   ->   balk
or   ->   be
ora   ->   ben
ore   ->   ber
orf   ->   bes
orna   ->   bean
orphan   ->   becuna
ort   ->   beg
ory   ->   bel
Ova   ->   bin
ova   ->   bin
ovey   ->   birl
P   ->   c
p   ->   c
pent   ->   crag
pern   ->   crea
Perry   ->   creel
perry   ->   creel
Phil   ->   cuvy
pho   ->   cub
pub   ->   cho
pun   ->   cha
pung   ->   chat
Puno   ->   chab
puny   ->   chal
pur   ->   che
purr   ->   chee
purre   ->   cheer
purrel   ->   cheery
Pyrex   ->   clerk
pyrex   ->   clerk
Q   ->   d
q   ->   d
qubba   ->   dhoon
R   ->   e
r   ->   e
ra   ->   en
rail   ->   envy
re   ->   er
rear   ->   erne
Ree   ->   err
ree   ->   err
ref   ->   ers
ret   ->   erg
S   ->   f
s   ->   f
sen   ->   fra
serve   ->   freir
sh   ->   fu
sha   ->   fun
shag   ->   funt
she   ->   fur
Shel   ->   fury
Sho   ->   fub
sho   ->   fub
shool   ->   fubby
snag   ->   fant
sneb   ->   faro
sync   ->   flap
T   ->   g
t   ->   g
tane   ->   gnar
Tang   ->   gnat
tang   ->   gnat
tee   ->   grr
ten   ->   gra
teng   ->   grat
terral   ->   greeny
tha   ->   gun
than   ->   guna
thaw   ->   gunj
The   ->   gur
the   ->   gur
thee   ->   gurr
they   ->   gurl
thy   ->   gul
tra   ->   gen
trag   ->   gent
trah   ->   genu
Tran   ->   gena
tref   ->   gers
try   ->   gel
tung   ->   ghat
turr   ->   ghee
Tyrr   ->   glee
U   ->   h
u   ->   h
un   ->   ha
Una   ->   han
ur   ->   he
ura   ->   hen
ure   ->   her
urea   ->   hern
uva   ->   hin
V   ->   i
v   ->   i
vat   ->   ing
vex   ->   irk
viva   ->   ivin
W   ->   j
w   ->   j
whar   ->   june
X   ->   k
x   ->   k
Y   ->   l
y   ->   l
yn   ->   la
Z   ->   m
z   ->   m
I   ->   v
a   ->   n
ant   ->   nag
be   ->   or
gun   ->   tha
he   ->   ur
on   ->   ba
or   ->   be
rail   ->   envy
than   ->   guna
the   ->   gur
