'  ->  '
a  ->  n
a'  ->  n'
'a  ->  'n
'a'  ->  'n'
aa  ->  nn
aac  ->  nnp
aaf  ->  nns
aag  ->  nnt
aah  ->  nnu
aan  ->  nna
aana  ->  nnan
aanu  ->  nnah
aar  ->  nne
aath  ->  nngu
aau  ->  nnh
aav  ->  nni
aavs  ->  nnif
aaw  ->  nnj
ab  ->  no
aba  ->  non
abaa  ->  nonn
abaare  ->  nonner
abab  ->  nono
abah  ->  nonu
abairt  ->  nonveg
abala  ->  nonyn
abalar  ->  nonyne
aban  ->  nona
abana  ->  nonan
abanar  ->  nonane
abanara  ->  nonanen
abanel  ->  nonary
abap  ->  nonc
abar  ->  none
abara  ->  nonen
abarra  ->  noneen
abat  ->  nong
abaten  ->  nongra
abatran  ->  nongena
abb  ->  noo
abba  ->  noon
abbe  ->  noor
abbo  ->  noob
abby  ->  nool
abc  ->  nop
abe  ->  nor
abe'  ->  nor'
abear  ->  norne
abee  ->  norr
abeel  ->  norry
abeg  ->  nort
abel  ->  nory
aben  ->  nora
abeng  ->  norat
abeo  ->  norb
aber  ->  nore
abera  ->  noren
aberan  ->  norena
aberg  ->  noret
aberra  ->  noreen
abf  ->  nos
abg  ->  not
abger  ->  notre
abh  ->  nou
abha  ->  noun
abhal  ->  nouny
abhang  ->  nounat
abhra  ->  nouen
abi  ->  nov
abib  ->  novo
abibe  ->  novor
abil  ->  novy
abin  ->  nova
abina  ->  novan
abing  ->  novat
abir  ->  nove
abira  ->  noven
abire  ->  nover
abjura  ->  nowhen
abjurer  ->  nowhere
abk  ->  nox
abl  ->  noy
ablo  ->  noyb
ably  ->  noyl
abm  ->  noz
abn  ->  noa
abne  ->  noar
abo  ->  nob
abob  ->  nobo
abone  ->  nobar
aboo  ->  nobb
aboon  ->  nobba
abor  ->  nobe
abp  ->  noc
abq  ->  nod
abqb  ->  nodo
abr  ->  noe
abra  ->  noen
abre  ->  noer
abren  ->  noera
abry  ->  noel
abs  ->  nof
absent  ->  nofrag
abt  ->  nog
abten  ->  nogra
abu  ->  noh
abug  ->  noht
abuh  ->  nohu
abun  ->  noha
abur  ->  nohe
aburn  ->  nohea
abuy  ->  nohl
abv  ->  noi
abw  ->  noj
abx  ->  nok
aby  ->  nol
abyon  ->  nolba
abys  ->  nolf
abzar  ->  nomne
ac  ->  np
aca  ->  npn
acb  ->  npo
acc  ->  npp
ace  ->  npr
acf  ->  nps
acg  ->  npt
ach  ->  npu
aci  ->  npv
acp  ->  npc
acs  ->  npf
act  ->  npg
acu  ->  nph
acv  ->  npi
acx  ->  npk
acz  ->  npm
ad  ->  nq
adr  ->  nqe
adrak  ->  nqenx
adran  ->  nqena
ads  ->  nqf
ae  ->  nr
aea  ->  nrn
aean  ->  nrna
aeb  ->  nro
aef  ->  nrs
aefi  ->  nrsv
aeg  ->  nrt
aej  ->  nrw
aen  ->  nra
aeno  ->  nrab
aeo  ->  nrb
aep  ->  nrc
aer  ->  nre
aery  ->  nrel
aet  ->  nrg
aev  ->  nri
aew  ->  nrj
af  ->  ns
afa  ->  nsn
afb  ->  nso
afd  ->  nsq
afe  ->  nsr
afean  ->  nsrna
aff  ->  nss
affy  ->  nssl
afg  ->  nst
afi  ->  nsv
afj  ->  nsw
afn  ->  nsa
afp  ->  nsc
afrond  ->  nsebaq
afs  ->  nsf
afu  ->  nsh
afv  ->  nsi
ag  ->  nt
agb  ->  nto
agba  ->  nton
agc  ->  ntp
age  ->  ntr
agel  ->  ntry
agew  ->  ntrj
agg  ->  ntt
agga  ->  nttn
agh  ->  ntu
agj  ->  ntw
agn  ->  nta
agnath  ->  ntangu
agnon  ->  ntaba
ago  ->  ntb
agp  ->  ntc
agr  ->  nte
agrea  ->  ntern
agri  ->  ntev
ags  ->  ntf
agt  ->  ntg
agu  ->  nth
agv  ->  nti
agw  ->  ntj
agy  ->  ntl
agyz  ->  ntlm
ah  ->  nu
aha  ->  nun
ahaa  ->  nunn
ahaan  ->  nunna
ahab  ->  nuno
ahabe  ->  nunor
ahah  ->  nunu
ahan  ->  nuna
ahana  ->  nunan
ahang  ->  nunat
ahar  ->  nune
ahart  ->  nuneg
ahat  ->  nung
ahb  ->  nuo
ahe  ->  nur
ahea  ->  nurn
ahen  ->  nura
aher  ->  nure
ahern  ->  nurea
ahh  ->  nuu
ahin  ->  nuva
ahir  ->  nuve
ahl  ->  nuy
ahm  ->  nuz
ahn  ->  nua
ahna  ->  nuan
ahne  ->  nuar
aho  ->  nub
ahol  ->  nuby
ahon  ->  nuba
ahool  ->  nubby
ahp  ->  nuc
ahpu  ->  nuch
ahpun  ->  nucha
ahr  ->  nue
ahre  ->  nuer
ahrs  ->  nuef
ahs  ->  nuf
aht  ->  nug
ahu  ->  nuh
ahuh  ->  nuhu
ahun  ->  nuha
ahv  ->  nui
ahven  ->  nuira
ahvo  ->  nuib
ahy  ->  nul
ahz  ->  num
ai  ->  nv
aic  ->  nvp
aid  ->  nvq
aiez  ->  nvrm
ain  ->  nva
aip  ->  nvc
aiq  ->  nvd
air  ->  nve
airf  ->  nves
ait  ->  nvg
aiv  ->  nvi
aiz  ->  nvm
aj  ->  nw
ajb  ->  nwo
aje  ->  nwr
ajk  ->  nwx
ajl  ->  nwy
ajn  ->  nwa
ajo  ->  nwb
ajoa  ->  nwbn
ako  ->  nxb
akvon  ->  nxiba
al  ->  ny
ala  ->  nyn
alan  ->  nyna
alar  ->  nyne
alb  ->  nyo
alba  ->  nyon
albat  ->  nyong
albin  ->  nyova
ale  ->  nyr
alef  ->  nyrs
alen  ->  nyra
aler  ->  nyre
alera  ->  nyren
alere  ->  nyrer
alerg  ->  nyret
alf  ->  nys
alfa  ->  nysn
alfan  ->  nysna
alfr  ->  nyse
alg  ->  nyt
algu  ->  nyth
alh  ->  nyu
alha  ->  nyun
alk  ->  nyx
all  ->  nyy
alla  ->  nyyn
allu  ->  nyyh
aln  ->  nya
alna  ->  nyan
alnen  ->  nyara
alp  ->  nyc
alpr  ->  nyce
alpy  ->  nycl
alr  ->  nye
altera  ->  nygren
altyn  ->  nygla
alv  ->  nyi
alva  ->  nyin
alvo  ->  nyib
aly  ->  nyl
alz  ->  nym
am  ->  nz
ama  ->  nzn
amama  ->  nznzn
amr  ->  nze
amv  ->  nzi
amy  ->  nzl
an  ->  na
an'  ->  na'
ana  ->  nan
anaa  ->  nann
anaal  ->  nanny
anaana  ->  nannan
anaf  ->  nans
anag  ->  nant
anah  ->  nanu
anan  ->  nana
anana  ->  nanan
anand  ->  nanaq
anane  ->  nanar
anann  ->  nanaa
anap  ->  nanc
anar  ->  nane
anat  ->  nang
anati  ->  nangv
anav  ->  nani
anava  ->  nanin
anba  ->  naon
anc  ->  nap
ancc  ->  napp
anch  ->  napu
anche  ->  napur
anchen  ->  napura
ancla  ->  napyn
ancon  ->  napba
ancona  ->  napban
ancre  ->  naper
ancs  ->  napf
and  ->  naq
anden  ->  naqra
andi  ->  naqv
andon  ->  naqba
ane  ->  nar
aneb  ->  naro
aneena  ->  narran
aneh  ->  naru
anel  ->  nary
anen  ->  nara
anena  ->  naran
aneng  ->  narat
anent  ->  narag
aner  ->  nare
anes  ->  narf
anet  ->  narg
anex  ->  nark
anf  ->  nas
anfon  ->  nasba
ang  ->  nat
angang  ->  natnat
angent  ->  natrag
anghel  ->  natury
angl  ->  naty
angr  ->  nate
angre  ->  nater
angren  ->  natera
angrer  ->  natere
angry  ->  natel
angu  ->  nath
angur  ->  nathe
angure  ->  nather
angy  ->  natl
anh  ->  nau
ani  ->  nav
ania  ->  navn
anian  ->  navna
aniar  ->  navne
anib  ->  navo
aniba  ->  navon
anien  ->  navra
anif  ->  navs
anil  ->  navy
anin  ->  nava
anina  ->  navan
aning  ->  navat
anione  ->  navbar
anj  ->  naw
anja  ->  nawn
anjova  ->  nawbin
ankre  ->  naxer
anm  ->  naz
ann  ->  naa
anna  ->  naan
annan  ->  naana
annat  ->  naang
anne  ->  naar
annen  ->  naara
annin  ->  naava
annina  ->  naavan
anning  ->  naavat
anno  ->  naab
anns  ->  naaf
annt  ->  naag
ano  ->  nab
anod  ->  nabq
anol  ->  naby
anon  ->  naba
anona  ->  naban
anone  ->  nabar
anong  ->  nabat
anonn  ->  nabaa
anoo  ->  nabb
anoor  ->  nabbe
anor  ->  nabe
anoy  ->  nabl
anp  ->  nac
anpr  ->  nace
ans  ->  naf
ansa  ->  nafn
ansan  ->  nafna
ansera  ->  nafren
ansere  ->  nafrer
anss  ->  naff
ant  ->  nag
ante  ->  nagr
anten  ->  nagra
antenal  ->  nagrany
antenn  ->  nagraa
antra  ->  nagen
antrag  ->  nagent
antre  ->  nager
antu  ->  nagh
antv  ->  nagi
anty  ->  nagl
anu  ->  nah
anug  ->  naht
anuh  ->  nahu
anuna  ->  nahan
anur  ->  nahe
anura  ->  nahen
anv  ->  nai
anvan  ->  naina
anvi  ->  naiv
anvn  ->  naia
anvr  ->  naie
anx  ->  nak
any  ->  nal
anz  ->  nam
anza  ->  namn
anzan  ->  namna
anzen  ->  namra
anzu  ->  namh
ao  ->  nb
aoa  ->  nbn
aoc  ->  nbp
aod  ->  nbq
aoe  ->  nbr
aog  ->  nbt
aoi  ->  nbv
aoj  ->  nbw
aol  ->  nby
aon  ->  nba
aop  ->  nbc
aor  ->  nbe
aot  ->  nbg
aow  ->  nbj
ap  ->  nc
apb  ->  nco
apc  ->  ncp
ape  ->  ncr
apean  ->  ncrna
apee  ->  ncrr
apg  ->  nct
apk  ->  ncx
apn  ->  nca
app  ->  ncc
apr  ->  nce
apt  ->  ncg
apun  ->  ncha
apura  ->  nchen
apuva  ->  nchin
apv  ->  nci
apy  ->  ncl
apyo  ->  nclb
aq  ->  nd
aqa  ->  ndn
aqan  ->  ndna
aqs  ->  ndf
ar  ->  ne
ara  ->  nen
araara  ->  nennen
arab  ->  neno
araf  ->  nens
arag  ->  nent
arah  ->  nenu
araha  ->  nenun
aran  ->  nena
araq  ->  nend
arar  ->  nene
arara  ->  nenen
ararat  ->  neneng
arat  ->  neng
aratra  ->  nengen
arava  ->  nenin
aravan  ->  nenina
arb  ->  neo
arba  ->  neon
arban  ->  neona
arbana  ->  neonan
arbe  ->  neor
arc  ->  nep
arcba  ->  nepon
archa  ->  nepun
arcra  ->  nepen
arcu  ->  neph
ard  ->  neq
are  ->  ner
'are  ->  'ner
areba  ->  neron
areg  ->  nert
areh  ->  neru
arei  ->  nerv
arej  ->  nerw
arek  ->  nerx
arel  ->  nery
arem  ->  nerz
aren  ->  nera
areon  ->  nerba
areq  ->  nerd
arer  ->  nere
arere  ->  nerer
ares  ->  nerf
areva  ->  nerin
arf  ->  nes
arfar  ->  nesne
arff  ->  ness
arfr  ->  nese
arg  ->  net
argan  ->  netna
argb  ->  neto
argen  ->  netra
arger  ->  netre
argh  ->  netu
arghe  ->  netur
arghen  ->  netura
argher  ->  neture
argr  ->  nete
argtha  ->  netgun
argu  ->  neth
arh  ->  neu
ari  ->  nev
aria  ->  nevn
arian  ->  nevna
arib  ->  nevo
ariba  ->  nevon
arien  ->  nevra
arier  ->  nevre
ariere  ->  nevrer
arif  ->  nevs
arin  ->  neva
arina  ->  nevan
arinan  ->  nevana
arine  ->  nevar
aring  ->  nevat
arinn  ->  nevaa
arira  ->  neven
arire  ->  never
arj  ->  new
ark  ->  nex
arl  ->  ney
arm  ->  nez
armana  ->  neznan
arn  ->  nea
arna  ->  nean
arnar  ->  neane
arne  ->  near
arnel  ->  neary
arnen  ->  neara
arner  ->  neare
arng  ->  neat
arns  ->  neaf
arny  ->  neal
aro  ->  neb
aroa  ->  nebn
arob  ->  nebo
arobe  ->  nebor
arof  ->  nebs
aroh  ->  nebu
aroha  ->  nebun
aron  ->  neba
arong  ->  nebat
aroo  ->  nebb
aror  ->  nebe
arora  ->  neben
arp  ->  nec
arpar  ->  necne
arpu  ->  nech
arr  ->  nee
arra  ->  neen
arre  ->  neer
arren  ->  neera
arrer  ->  neere
arri  ->  neev
arro  ->  neeb
arrobe  ->  neebor
arrs  ->  neef
ars  ->  nef
arsan  ->  nefna
arsaq  ->  nefnd
arsar  ->  nefne
art  ->  neg
arte  ->  negr
arten  ->  negra
artene  ->  negrar
arter  ->  negre
artere  ->  negrer
arterna  ->  negrean
arterne  ->  negrear
arth  ->  negu
arthen  ->  negura
arthra  ->  neguen
artur  ->  neghe
arty  ->  negl
aru  ->  neh
arun  ->  neha
aruna  ->  nehan
arv  ->  nei
arva  ->  nein
arve  ->  neir
arven  ->  neira
arvi  ->  neiv
arvn  ->  neia
arvs  ->  neif
arvt  ->  neig
arvy  ->  neil
arwr  ->  neje
arx  ->  nek
ary  ->  nel
arz  ->  nem
arzana  ->  nemnan
arzh  ->  nemu
as  ->  nf
ase  ->  nfr
asf  ->  nfs
asg  ->  nft
ash  ->  nfu
asi  ->  nfv
asn  ->  nfa
asp  ->  nfc
asq  ->  nfd
ast  ->  nfg
asv  ->  nfi
asw  ->  nfj
asx  ->  nfk
asy  ->  nfl
at  ->  ng
ata  ->  ngn
atb  ->  ngo
atc  ->  ngp
ate  ->  ngr
ater  ->  ngre
ateru  ->  ngreh
atf  ->  ngs
atg  ->  ngt
ath  ->  ngu
atha  ->  ngun
athen  ->  ngura
athl  ->  nguy
athon  ->  nguba
aththa  ->  ngugun
athy  ->  ngul
atl  ->  ngy
atna  ->  ngan
atnam  ->  nganz
atnu  ->  ngah
ato  ->  ngb
atof  ->  ngbs
atp  ->  ngc
atr  ->  nge
atra  ->  ngen
ats  ->  ngf
atur  ->  nghe
atura  ->  nghen
aturan  ->  nghena
atv  ->  ngi
aty  ->  ngl
atz  ->  ngm
au  ->  nh
aub  ->  nho
auc  ->  nhp
auer  ->  nhre
auf  ->  nhs
aug  ->  nht
auh  ->  nhu
auj  ->  nhw
aula  ->  nhyn
aum  ->  nhz
aun  ->  nha
auna  ->  nhan
aunat  ->  nhang
aune  ->  nhar
aunz  ->  nham
aup  ->  nhc
aur  ->  nhe
aura  ->  nhen
aurr  ->  nhee
aut  ->  nhg
auv  ->  nhi
auve  ->  nhir
auz  ->  nhm
auza  ->  nhmn
av  ->  ni
ava  ->  nin
avaan  ->  ninna
avaava  ->  ninnin
avah  ->  ninu
avam  ->  ninz
avan  ->  nina
avana  ->  ninan
avant  ->  ninag
avar  ->  nine
avare  ->  niner
avat  ->  ning
avava  ->  ninin
avc  ->  nip
avd  ->  niq
ave  ->  nir
aven  ->  nira
aver  ->  nire
avera  ->  niren
aves  ->  nirf
avg  ->  nit
avger  ->  nitre
avgn  ->  nita
avi  ->  niv
avin  ->  niva
avina  ->  nivan
avine  ->  nivar
avir  ->  nive
avive  ->  nivir
avl  ->  niy
avlb  ->  niyo
avm  ->  niz
avn  ->  nia
avo  ->  nib
avon  ->  niba
avoyr  ->  nible
avp  ->  nic
avpu  ->  nich
avra  ->  nien
avram  ->  nienz
avre  ->  nier
avri  ->  niev
avrir  ->  nieve
avro  ->  nieb
avs  ->  nif
avu  ->  nih
avun  ->  niha
avuna  ->  nihan
avuy  ->  nihl
aw  ->  nj
awaw  ->  njnj
awbs  ->  njof
awes  ->  njrf
awn  ->  nja
awner  ->  njare
awr  ->  nje
awra  ->  njen
awre  ->  njer
awry  ->  njel
ax  ->  nk
axe  ->  nkr
axeb  ->  nkro
axj  ->  nkw
axr  ->  nke
ay  ->  nl
ayc  ->  nlp
ayd  ->  nlq
aye  ->  nlr
ayn  ->  nla
ayr  ->  nle
ayy  ->  nll
az  ->  nm
aza  ->  nmn
azaz  ->  nmnm
aze  ->  nmr
azj  ->  nmw
azn  ->  nma
azz  ->  nmm
b  ->  o
b'  ->  o'
ba  ->  on
'ba  ->  'on
baa  ->  onn
baabe  ->  onnor
baah  ->  onnu
baahe  ->  onnur
baan  ->  onna
baana  ->  onnan
baar  ->  onne
baara  ->  onnen
baarn  ->  onnea
bab  ->  ono
baba  ->  onon
baban  ->  onona
babana  ->  ononan
babava  ->  ononin
babe  ->  onor
baben  ->  onora
baber  ->  onore
bac  ->  onp
bach  ->  onpu
bacn  ->  onpa
bael  ->  onry
baen  ->  onra
baf  ->  ons
bag  ->  ont
bager  ->  ontre
bagn  ->  onta
bagna  ->  ontan
bagr  ->  onte
bagres  ->  onterf
bah  ->  onu
baha  ->  onun
bahe  ->  onur
bahon  ->  onuba
bajrer  ->  onwere
bal  ->  ony
balb  ->  onyo
balba  ->  onyon
balbe  ->  onyor
balk  ->  onyx
bam  ->  onz
ban  ->  ona
bana  ->  onan
banan  ->  onana
bane  ->  onar
banhe  ->  onaur
banten  ->  onagra
banter  ->  onagre
bap  ->  onc
bapur  ->  onche
baqra  ->  onden
bar  ->  one
'bar  ->  'one
bara  ->  onen
barat  ->  oneng
barb  ->  oneo
barbar  ->  oneone
bare  ->  oner
barein  ->  onerva
barel  ->  onery
baren  ->  onera
barene  ->  onerar
bareng  ->  onerat
barer  ->  onere
barere  ->  onerer
barf  ->  ones
bargu  ->  oneth
barn  ->  onea
barr  ->  onee
barre  ->  oneer
bart  ->  oneg
barwne  ->  onejar
baryn  ->  onela
bat  ->  ong
batav  ->  ongni
batf  ->  ongs
bath  ->  ongu
bathy  ->  ongul
batna  ->  ongan
batra  ->  ongen
batre  ->  onger
baty  ->  ongl
bauna  ->  onhan
bav  ->  oni
bava  ->  onin
baw  ->  onj
bawn  ->  onja
bax  ->  onk
bayne  ->  onlar
bayraq  ->  onlend
baz  ->  onm
bb  ->  oo
bba  ->  oon
bbar  ->  oone
bbb  ->  ooo
bbc  ->  oop
bbe  ->  oor
bber  ->  oore
bbg  ->  oot
bbi  ->  oov
bbl  ->  ooy
bbn  ->  ooa
bbp  ->  ooc
bbq  ->  ood
bbs  ->  oof
bbt  ->  oog
bc  ->  op
bca  ->  opn
bcb  ->  opo
bcbg  ->  opot
bcc  ->  opp
bcf  ->  ops
bcg  ->  opt
bci  ->  opv
bcl  ->  opy
bcn  ->  opa
bcnf  ->  opas
bcnu  ->  opah
bcp  ->  opc
bcr  ->  ope
bcv  ->  opi
bcva  ->  opin
bd  ->  oq
bde  ->  oqr
bdv  ->  oqi
be  ->  or
bea  ->  orn
beab  ->  orno
beah  ->  ornu
beal  ->  orny
bean  ->  orna
beana  ->  ornan
beane  ->  ornar
beanen  ->  ornara
beaner  ->  ornare
bear  ->  orne
beare  ->  orner
bearen  ->  ornera
bearer  ->  ornere
bearg  ->  ornet
bearm  ->  ornez
bearr  ->  ornee
beart  ->  orneg
beavat  ->  orning
beb  ->  oro
beba  ->  oron
beban  ->  orona
bebe  ->  oror
becuna  ->  orphan
bedna  ->  orqan
bee  ->  orr
beeb  ->  orro
beebe  ->  orror
been  ->  orra
beene  ->  orrar
beer  ->  orre
beera  ->  orren
beery  ->  orrel
beeve  ->  orrir
beever  ->  orrire
bef  ->  ors
beg  ->  ort
begg  ->  ortt
begra  ->  orten
begre  ->  orter
begry  ->  ortel
begun  ->  ortha
beh  ->  oru
beha  ->  orun
bei  ->  orv
beir  ->  orve
belk  ->  oryx
bely  ->  oryl
bem  ->  orz
ben  ->  ora
bena  ->  oran
benam  ->  oranz
benan  ->  orana
benar  ->  orane
benat  ->  orang
bend  ->  oraq
bene  ->  orar
benen  ->  orara
bener  ->  orare
benevn  ->  oraria
beng  ->  orat
beni  ->  orav
benin  ->  orava
benina  ->  oravan
bening  ->  oravat
benn  ->  oraa
benna  ->  oraan
benny  ->  oraal
benon  ->  oraba
benone  ->  orabar
benu  ->  orah
benwa  ->  orajn
benyn  ->  orala
benz  ->  oram
beo  ->  orb
beol  ->  orby
beon  ->  orba
beor  ->  orbe
beorg  ->  orbet
bep  ->  orc
beq  ->  ord
beqar  ->  ordne
ber  ->  ore
bera  ->  oren
berag  ->  orent
beran  ->  orena
berar  ->  orene
bere  ->  orer
beren  ->  orera
berf  ->  ores
berg  ->  oret
bergr  ->  orete
berm  ->  orez
bern  ->  orea
berna  ->  orean
berne  ->  orear
bernen  ->  oreara
berner  ->  oreare
bernera  ->  orearen
bernon  ->  oreaba
bero  ->  oreb
berr  ->  oree
berra  ->  oreen
bert  ->  oreg
beru  ->  oreh
berw  ->  orej
berx  ->  orek
bery  ->  orel
berz  ->  orem
bes  ->  orf
besra  ->  orfen
bet  ->  org
betar  ->  orgne
betha  ->  orgun
bethy  ->  orgul
betl  ->  orgy
betla  ->  orgyn
betr  ->  orge
betrar  ->  orgene
betyr  ->  orgle
bev  ->  ori
beva  ->  orin
bevan  ->  orina
bevar  ->  orine
bevara  ->  orinen
bever  ->  orire
bevere  ->  orirer
beverer  ->  orirere
bevor  ->  oribe
bevre  ->  orier
bevrer  ->  oriere
bevy  ->  oril
bevyr  ->  orile
bew  ->  orj
bewb  ->  orjo
bey  ->  orl
beyl  ->  orly
beyn  ->  orla
beyne  ->  orlar
beyng  ->  orlat
beynin  ->  orlava
beynon  ->  orlaba
bez  ->  orm
beze  ->  ormr
bf  ->  os
bfa  ->  osn
bfc  ->  osp
bfcs  ->  ospf
bff  ->  oss
bfg  ->  ost
bfh  ->  osu
bfi  ->  osv
bfp  ->  osc
bfr  ->  ose
bfs  ->  osf
b'g  ->  o't
bg  ->  ot
bgb  ->  oto
bge  ->  otr
bger  ->  otre
bgh  ->  otu
bgn  ->  ota
bgp  ->  otc
bgr  ->  ote
bgt  ->  otg
bgu  ->  oth
bh  ->  ou
bhb  ->  ouo
bhr  ->  oue
bhs  ->  ouf
bht  ->  oug
bhu  ->  ouh
bi  ->  ov
bia  ->  ovn
bian  ->  ovna
biar  ->  ovne
biara  ->  ovnen
bib  ->  ovo
biba  ->  ovon
bibb  ->  ovoo
bibe  ->  ovor
bic  ->  ovp
bieb  ->  ovro
bien  ->  ovra
biene  ->  ovrar
biere  ->  ovrer
bievre  ->  ovrier
bif  ->  ovs
bih  ->  ovu
biir  ->  ovve
bil  ->  ovy
bin  ->  ova
bina  ->  ovan
binan  ->  ovana
binar  ->  ovane
bine  ->  ovar
binen  ->  ovara
biner  ->  ovare
bing  ->  ovat
bingh  ->  ovatu
binin  ->  ovava
binny  ->  ovaal
binob  ->  ovabo
binon  ->  ovaba
bip  ->  ovc
bir  ->  ove
bira  ->  oven
biran  ->  ovena
bire  ->  over
biren  ->  overa
birer  ->  overe
birg  ->  ovet
birn  ->  ovea
birra  ->  oveen
biv  ->  ovi
biva  ->  ovin
bj  ->  ow
bja  ->  own
bjf  ->  ows
bjj  ->  oww
bjn  ->  owa
bk  ->  ox
bkn  ->  oxa
bkv  ->  oxi
bl  ->  oy
blan  ->  oyna
blar  ->  oyne
blb  ->  oyo
ble  ->  oyr
blen  ->  oyra
blev  ->  oyri
bln  ->  oya
blr  ->  oye
blw  ->  oyj
bly  ->  oyl
bm  ->  oz
bma  ->  ozn
bme  ->  ozr
bming  ->  ozvat
bmv  ->  ozi
bn  ->  oa
bna  ->  oan
bnc  ->  oap
bne  ->  oar
bneq  ->  oard
bnf  ->  oas
bni  ->  oav
bno  ->  oab
bnp  ->  oac
bnr  ->  oae
bns  ->  oaf
bnsf  ->  oafs
bnw  ->  oaj
bo  ->  ob
boan  ->  obna
bob  ->  obo
boba  ->  obon
bobb  ->  oboo
bobe  ->  obor
boben  ->  obora
bobl  ->  oboy
bobr  ->  oboe
bobra  ->  oboen
bobre  ->  oboer
boby  ->  obol
bobyr  ->  obole
boc  ->  obp
boe  ->  obr
boeg  ->  obrt
boei  ->  obrv
boel  ->  obry
boen  ->  obra
boene  ->  obrar
boenen  ->  obrara
boer  ->  obre
boera  ->  obren
boere  ->  obrer
boeren  ->  obrera
boeve  ->  obrir
bof  ->  obs
bofrer  ->  obsere
bogre  ->  obter
boh  ->  obu
bohi  ->  obuv
bohm  ->  obuz
bohn  ->  obua
bohr  ->  obue
bohy  ->  obul
boil  ->  obvy
boivre  ->  obvier
bok  ->  obx
bol  ->  oby
bombe  ->  obzor
bon  ->  oba
bona  ->  oban
bonan  ->  obana
bonat  ->  obang
bone  ->  obar
bonen  ->  obara
bong  ->  obat
bonin  ->  obava
bonon  ->  obaba
bony  ->  obal
boo  ->  obb
boob  ->  obbo
bool  ->  obby
boole  ->  obbyr
boon  ->  obba
bop  ->  obc
bor  ->  obe
bora  ->  oben
borat  ->  obeng
borb  ->  obeo
bore  ->  ober
boreen  ->  oberra
boreh  ->  oberu
boren  ->  obera
borer  ->  obere
borh  ->  obeu
bork  ->  obex
borm  ->  obez
born  ->  obea
borne  ->  obear
borner  ->  obeare
bornu  ->  obeah
boro  ->  obeb
borun  ->  obeha
bory  ->  obel
bot  ->  obg
bov  ->  obi
bova  ->  obin
bow  ->  obj
boyn  ->  obla
boyr  ->  oble
bp  ->  oc
bpa  ->  ocn
bpb  ->  oco
bpc  ->  ocp
bpf  ->  ocs
bph  ->  ocu
bpo  ->  ocb
bpp  ->  occ
bppv  ->  occi
bpr  ->  oce
bq  ->  od
bqe  ->  odr
bqs  ->  odf
br  ->  oe
bra  ->  oen
brah  ->  oenu
bran  ->  oena
brar  ->  oene
brava  ->  oenin
bre  ->  oer
breh  ->  oeru
brer  ->  oere
brev  ->  oeri
breyr  ->  oerle
brh  ->  oeu
bri  ->  oev
brien  ->  oevra
brier  ->  oevre
briere  ->  oevrer
brif  ->  oevs
brn  ->  oea
bro  ->  oeb
brp  ->  oec
brr  ->  oee
brs  ->  oef
brv  ->  oei
brx  ->  oek
bry  ->  oel
bryf  ->  oels
bryn  ->  oela
brz  ->  oem
bs  ->  of
bsa  ->  ofn
bse  ->  ofr
bsf  ->  ofs
bsg  ->  oft
bsn  ->  ofa
bsp  ->  ofc
bss  ->  off
bt  ->  og
bta  ->  ogn
btb  ->  ogo
btba  ->  ogon
bte  ->  ogr
bth  ->  ogu
btha  ->  ogun
btn  ->  oga
btp  ->  ogc
btt  ->  ogg
btu  ->  ogh
bu  ->  oh
bua  ->  ohn
buah  ->  ohnu
buar  ->  ohne
buav  ->  ohni
bub  ->  oho
buba  ->  ohon
bubar  ->  ohone
bubu  ->  ohoh
buc  ->  ohp
bue  ->  ohr
buef  ->  ohrs
buen  ->  ohra
buena  ->  ohran
buer  ->  ohre
buf  ->  ohs
bug  ->  oht
bugn  ->  ohta
buh  ->  ohu
buhv  ->  ohui
bulo  ->  ohyb
bun  ->  oha
bunan  ->  ohana
bune  ->  ohar
bup  ->  ohc
buq  ->  ohd
bur  ->  ohe
bura  ->  ohen
burar  ->  ohene
burara  ->  ohenen
burav  ->  oheni
burn  ->  ohea
burna  ->  ohean
burra  ->  oheen
bury  ->  ohel
but  ->  ohg
buu  ->  ohh
bux  ->  ohk
buz  ->  ohm
bv  ->  oi
bvg  ->  oit
bvp  ->  oic
bvr  ->  oie
bw  ->  oj
bwb  ->  ojo
bwe  ->  ojr
bwn  ->  oja
bwr  ->  oje
bwrw  ->  ojej
bwv  ->  oji
bx  ->  ok
bxo  ->  okb
by  ->  ol
bybi  ->  olov
bybo  ->  olob
byf  ->  ols
byg  ->  olt
bygen  ->  oltra
byger  ->  oltre
bygning  ->  oltavat
byl  ->  oly
byn  ->  ola
byna  ->  olan
byng  ->  olat
byns  ->  olaf
byp  ->  olc
byr  ->  ole
byre  ->  oler
byrg  ->  olet
byri  ->  olev
byrj  ->  olew
byrn  ->  olea
byrne  ->  olear
byrr  ->  olee
bys  ->  olf
by't  ->  ol'g
byt  ->  olg
byt'  ->  olg'
byth  ->  olgu
byu  ->  olh
byun  ->  olha
byvre  ->  olier
byw  ->  olj
bz  ->  om
bziny  ->  omval
bzj  ->  omw
bzon  ->  omba
bzp  ->  omc
bzy  ->  oml
bzz  ->  omm
c  ->  p
c'  ->  p'
ca  ->  pn
caa  ->  pnn
caaf  ->  pnns
cac  ->  pnp
cad  ->  pnq
cae  ->  pnr
caf  ->  pns
caff  ->  pnss
cah  ->  pnu
cai  ->  pnv
caj  ->  pnw
calk  ->  pnyx
can  ->  pna
cao  ->  pnb
cap  ->  pnc
caq  ->  pnd
car  ->  pne
cas  ->  pnf
cat  ->  png
cav  ->  pni
cay  ->  pnl
caz  ->  pnm
cb  ->  po
cba  ->  pon
cbar  ->  pone
cbbc  ->  poop
cbc  ->  pop
cbe  ->  por
cber  ->  pore
cbf  ->  pos
cbg  ->  pot
cbi  ->  pov
cbj  ->  pow
cbm  ->  poz
cbn  ->  poa
cbo  ->  pob
cbor  ->  pobe
cbp  ->  poc
cbpp  ->  pocc
cbq  ->  pod
cbr  ->  poe
cbrn  ->  poea
cbs  ->  pof
cbsn  ->  pofa
cbt  ->  pog
cc  ->  pp
cca  ->  ppn
ccb  ->  ppo
ccc  ->  ppp
ccd  ->  ppq
cce  ->  ppr
ccf  ->  pps
ccg  ->  ppt
ccgc  ->  pptp
cci  ->  ppv
ccj  ->  ppw
ccn  ->  ppa
cco  ->  ppb
ccp  ->  ppc
ccq  ->  ppd
ccr  ->  ppe
ccs  ->  ppf
cct  ->  ppg
ccu  ->  pph
ccv  ->  ppi
ccy  ->  ppl
cd  ->  pq
cda  ->  pqn
cdc  ->  pqp
cdd  ->  pqq
cdf  ->  pqs
cdg  ->  pqt
ce  ->  pr
cea  ->  prn
ceba  ->  pron
ceban  ->  prona
cebane  ->  pronar
cebar  ->  prone
cebare  ->  proner
cebe  ->  pror
ceben  ->  prora
ceber  ->  prore
cebi  ->  prov
cebine  ->  provar
cebo  ->  prob
cebola  ->  probyn
cebon  ->  proba
cebong  ->  probat
cec  ->  prp
cece  ->  prpr
cee  ->  prr
cef  ->  prs
cefn  ->  prsa
cefr  ->  prse
ceg  ->  prt
ceh  ->  pru
cei  ->  prv
cel  ->  pry
celaba  ->  prynon
celan  ->  pryna
celf  ->  prys
celi  ->  pryv
cels  ->  pryf
cen  ->  pra
cena  ->  pran
cenah  ->  pranu
cenan  ->  prana
cenar  ->  prane
cenat  ->  prang
ceng  ->  prat
cengh  ->  pratu
cenh  ->  prau
ceni  ->  prav
cenn  ->  praa
cenna  ->  praan
cenny  ->  praal
cens  ->  praf
cent  ->  prag
centre  ->  prager
cenu  ->  prah
ceny  ->  pral
ceo  ->  prb
cep  ->  prc
ceph  ->  prcu
cepi  ->  prcv
cer  ->  pre
cera  ->  pren
cerah  ->  prenu
cerare  ->  prener
cerat  ->  preng
cerb  ->  preo
cerba  ->  preon
cerc  ->  prep
cercha  ->  prepun
cerchan  ->  prepuna
cerchar  ->  prepune
cerean  ->  prerna
cerer  ->  prere
cerf  ->  pres
ceri  ->  prev
cerir  ->  preve
cerk  ->  prex
cern  ->  prea
cerna  ->  prean
cerne  ->  prear
cernen  ->  preara
cerner  ->  preare
cernera  ->  prearen
cernez  ->  prearm
cerno  ->  preab
cerone  ->  prebar
ceror  ->  prebe
cerra  ->  preen
cerrare  ->  preener
cers  ->  pref
cert  ->  preg
certan  ->  pregna
certh  ->  pregu
ceru  ->  preh
cerva  ->  prein
cerw  ->  prej
ceryn  ->  prela
cet  ->  prg
ceu  ->  prh
cev  ->  pri
ceva  ->  prin
cevam  ->  prinz
cevap  ->  princ
cevar  ->  prine
cevat  ->  pring
cevi  ->  priv
cevy  ->  pril
cew  ->  prj
cex  ->  prk
cez  ->  prm
cf  ->  ps
cfa  ->  psn
cfav  ->  psni
cfc  ->  psp
cfg  ->  pst
cfh  ->  psu
cfi  ->  psv
cfk  ->  psx
cfl  ->  psy
cfn  ->  psa
cfo  ->  psb
cfr  ->  pse
cft  ->  psg
cg  ->  pt
cgb  ->  pto
cgcc  ->  ptpp
cge  ->  ptr
cgj  ->  ptw
cgn  ->  pta
cgo  ->  ptb
cgp  ->  ptc
c'h  ->  p'u
ch  ->  pu
cha  ->  pun
chaang  ->  punnat
chaaq  ->  punnd
chab  ->  puno
chaba  ->  punon
chaf  ->  puns
chagna  ->  puntan
chagnon  ->  puntaba
chagra  ->  punten
chah  ->  punu
chak  ->  punx
chakra  ->  punxen
chal  ->  puny
chalf  ->  punys
chalve  ->  punyir
chan  ->  puna
chana  ->  punan
chanan  ->  punana
chanar  ->  punane
chane  ->  punar
chang  ->  punat
channa  ->  punaan
chanp  ->  punac
chanu  ->  punah
chap  ->  punc
chapu  ->  punch
chapur  ->  punche
char  ->  pune
chara  ->  punen
charag  ->  punent
chary  ->  punel
chat  ->  pung
chath  ->  pungu
chatrin  ->  pungeva
chatt  ->  pungg
chau  ->  punh
chaun  ->  punha
chav  ->  puni
chava  ->  punin
chave  ->  punir
chavena  ->  puniran
chaver  ->  punire
chavere  ->  punirer
chavin  ->  puniva
chavirer  ->  punivere
chavra  ->  punien
chawn  ->  punja
chayn  ->  punla
chb  ->  puo
chch  ->  pupu
chd  ->  puq
che  ->  pur
cheann  ->  purnaa
cheb  ->  puro
cheba  ->  puron
chec  ->  purp
checava  ->  purpnin
chech  ->  purpu
cheche  ->  purpur
chechen  ->  purpura
chechena  ->  purpuran
chee  ->  purr
cheef  ->  purrs
cheel  ->  purry
cheer  ->  purre
cheere  ->  purrer
cheery  ->  purrel
chef  ->  purs
chegre  ->  purter
cheif  ->  purvs
chein  ->  purva
chelp  ->  puryc
chen  ->  pura
chena  ->  puran
cheng  ->  purat
chenin  ->  purava
cheon  ->  purba
cher  ->  pure
chera  ->  puren
chere  ->  purer
cherere  ->  purerer
cherf  ->  pures
cherl  ->  purey
cherne  ->  purear
cheryl  ->  purely
chetna  ->  purgan
chev  ->  puri
chevs  ->  purif
chevy  ->  puril
chewn  ->  purja
chf  ->  pus
chg  ->  put
chh  ->  puu
chhe  ->  puur
chhun  ->  puuha
chir  ->  puve
chiv  ->  puvi
chl  ->  puy
chly  ->  puyl
chn  ->  pua
ch'na  ->  pu'an
cho  ->  pub
chob  ->  pubo
choba  ->  pubon
chone  ->  pubar
choon  ->  pubba
chor  ->  pube
chora  ->  puben
chorar  ->  pubene
chore  ->  puber
chov  ->  pubi
chova  ->  pubin
chp  ->  puc
chr  ->  pue
chra  ->  puen
chren  ->  puera
chs  ->  puf
cht  ->  pug
chu  ->  puh
chub  ->  puho
chuhra  ->  puhuen
chun  ->  puha
chur  ->  puhe
churra  ->  puheen
chuy  ->  puhl
chvat  ->  puing
chw  ->  puj
chy  ->  pul
chyb  ->  pulo
chyba  ->  pulon
chymne  ->  pulzar
chyn  ->  pula
chyna  ->  pulan
chyne  ->  pular
chynne  ->  pulaar
chypre  ->  pulcer
chyra  ->  pulen
chyre  ->  puler
chz  ->  pum
ci  ->  pv
cia  ->  pvn
cibu  ->  pvoh
cic  ->  pvp
cie  ->  pvr
cief  ->  pvrs
cif  ->  pvs
cig  ->  pvt
cii  ->  pvv
cik  ->  pvx
cin  ->  pva
cip  ->  pvc
ciq  ->  pvd
cir  ->  pve
cis  ->  pvf
cj  ->  pw
cjap  ->  pwnc
ck  ->  px
cl  ->  py
cla  ->  pyn
claar  ->  pynne
clag  ->  pynt
clar  ->  pyne
clav  ->  pyni
clavat  ->  pyning
claw  ->  pynj
clb  ->  pyo
cle  ->  pyr
clem  ->  pyrz
clena  ->  pyran
cler  ->  pyre
clerk  ->  pyrex
clev  ->  pyri
clf  ->  pys
clg  ->  pyt
clk  ->  pyx
cll  ->  pyy
cln  ->  pya
clp  ->  pyc
clr  ->  pye
cls  ->  pyf
clt  ->  pyg
clu  ->  pyh
clv  ->  pyi
clx  ->  pyk
cly  ->  pyl
cm  ->  pz
cma  ->  pzn
cmc  ->  pzp
cmnf  ->  pzas
cmo  ->  pzb
cmr  ->  pze
c'n  ->  p'a
cn  ->  pa
cna  ->  pan
cnaa  ->  pann
cnag  ->  pant
cnau  ->  panh
cnave  ->  panir
cnc  ->  pap
cncf  ->  paps
cnd  ->  paq
cne  ->  par
cnf  ->  pas
cng  ->  pat
cnh  ->  pau
cni  ->  pav
cnif  ->  pavs
cnl  ->  pay
cnn  ->  paa
cno  ->  pab
cnp  ->  pac
cnr  ->  pae
cns  ->  paf
cnss  ->  paff
cnt  ->  pag
cntv  ->  pagi
cnud  ->  pahq
cnv  ->  pai
cnx  ->  pak
cny  ->  pal
co  ->  pb
coa  ->  pbn
cob  ->  pbo
coc  ->  pbp
cod  ->  pbq
coe  ->  pbr
cof  ->  pbs
cog  ->  pbt
coh  ->  pbu
cok  ->  pbx
com  ->  pbz
con  ->  pba
cona  ->  pban
cone  ->  pbar
conf  ->  pbas
coo  ->  pbb
coof  ->  pbbs
cop  ->  pbc
cos  ->  pbf
cot  ->  pbg
coti  ->  pbgv
cou  ->  pbh
cov  ->  pbi
cow  ->  pbj
coz  ->  pbm
cp  ->  pc
cpa  ->  pcn
cpb  ->  pco
cpc  ->  pcp
cpe  ->  pcr
cpf  ->  pcs
cpg  ->  pct
cpi  ->  pcv
cpk  ->  pcx
cpn  ->  pca
cpo  ->  pcb
cpp  ->  pcc
cpr  ->  pce
cpt  ->  pcg
cpu  ->  pch
cpv  ->  pci
cq  ->  pd
cqb  ->  pdo
cqc  ->  pdp
cqd  ->  pdq
cr  ->  pe
cra  ->  pen
craal  ->  penny
craane  ->  pennar
crab  ->  peno
craba  ->  penon
craber  ->  penore
craf  ->  pens
crag  ->  pent
crager  ->  pentre
cragers  ->  pentref
crah  ->  penu
cram  ->  penz
cran  ->  pena
crane  ->  penar
craner  ->  penare
crang  ->  penat
crare  ->  pener
crary  ->  penel
crashy  ->  penful
crat  ->  peng
craun  ->  penha
crava  ->  penin
cravat  ->  pening
crave  ->  penir
crawn  ->  penja
crax  ->  penk
crb  ->  peo
crc  ->  pep
cre  ->  per
crea  ->  pern
creag  ->  pernt
crean  ->  perna
crear  ->  perne
crearen  ->  pernera
crearer  ->  pernere
crearere  ->  pernerer
crearne  ->  pernear
creba  ->  peron
creban  ->  perona
crebar  ->  perone
creben  ->  perora
creber  ->  perore
crebo  ->  perob
crec  ->  perp
cred  ->  perq
cree  ->  perr
creel  ->  perry
creen  ->  perra
creer  ->  perre
cref  ->  pers
creg  ->  pert
creger  ->  pertre
crei  ->  perv
creil  ->  pervy
crem  ->  perz
cren  ->  pera
crena  ->  peran
crenat  ->  perang
creor  ->  perbe
crep  ->  perc
creper  ->  percre
crepu  ->  perch
crepur  ->  perche
crer  ->  pere
crera  ->  peren
creran  ->  perena
creren  ->  perera
creron  ->  pereba
cres  ->  perf
creu  ->  perh
crev  ->  peri
creva  ->  perin
crevan  ->  perina
crevar  ->  perine
creve  ->  perir
crever  ->  perire
crew  ->  perj
crex  ->  perk
crez  ->  perm
crf  ->  pes
crh  ->  peu
cri  ->  pev
crine  ->  pevar
crl  ->  pey
crla  ->  peyn
crm  ->  pez
crmb  ->  pezo
crn  ->  pea
crna  ->  pean
cro  ->  peb
cron  ->  peba
crore  ->  peber
crp  ->  pec
crrel  ->  peery
crt  ->  peg
crta  ->  pegn
crtu  ->  pegh
cru  ->  peh
crue  ->  pehr
crune  ->  pehar
crv  ->  pei
crva  ->  pein
crvena  ->  peiran
crwn  ->  peja
cry  ->  pel
cryan  ->  pelna
cryd  ->  pelq
cryf  ->  pels
cryn  ->  pela
crynwr  ->  pelaje
cryo  ->  pelb
crys  ->  pelf
cs  ->  pf
csc  ->  pfp
csf  ->  pfs
csg  ->  pft
csi  ->  pfv
csl  ->  pfy
cso  ->  pfb
csp  ->  pfc
css  ->  pff
csss  ->  pfff
csv  ->  pfi
csx  ->  pfk
ct  ->  pg
ctc  ->  pgp
ctcf  ->  pgps
cte  ->  pgr
ctf  ->  pgs
ctl  ->  pgy
ctn  ->  pga
ctp  ->  pgc
cts  ->  pgf
ctv  ->  pgi
ctz  ->  pgm
cu  ->  ph
cua  ->  phn
cub  ->  pho
cuba  ->  phon
cuban  ->  phona
cubar  ->  phone
cubare  ->  phoner
cubat  ->  phong
cubu  ->  phoh
cuc  ->  php
cue  ->  phr
cuen  ->  phra
cuera  ->  phren
cug  ->  pht
cuh  ->  phu
cui  ->  phv
cuif  ->  phvs
cuk  ->  phx
cul  ->  phy
culm  ->  phyz
culv  ->  phyi
cum  ->  phz
cun  ->  pha
cuna  ->  phan
cunar  ->  phane
cune  ->  phar
cunee  ->  pharr
cunen  ->  phara
cung  ->  phat
cunh  ->  phau
cunny  ->  phaal
cuntre  ->  phager
cunu  ->  phah
cuny  ->  phal
cuo  ->  phb
cur  ->  phe
cura  ->  phen
curabar  ->  phenone
cural  ->  pheny
curar  ->  phene
curb  ->  pheo
curba  ->  pheon
curg  ->  phet
curi  ->  phev
curor  ->  phebe
curre  ->  pheer
curun  ->  pheha
curzon  ->  phemba
cus  ->  phf
cuv  ->  phi
cuva  ->  phin
cuy  ->  phl
cuz  ->  phm
cv  ->  pi
cva  ->  pin
cval  ->  piny
cvat  ->  ping
cvc  ->  pip
cve  ->  pir
cvet  ->  pirg
cvi  ->  piv
cvn  ->  pia
cvns  ->  piaf
cvp  ->  pic
cvr  ->  pie
cvrs  ->  pief
cvs  ->  pif
cvt  ->  pig
cvv  ->  pii
cvx  ->  pik
cvz  ->  pim
cw  ->  pj
cwb  ->  pjo
cwg  ->  pjt
cx  ->  pk
cxc  ->  pkp
cxe  ->  pkr
cxf  ->  pks
cy  ->  pl
cya  ->  pln
cybc  ->  plop
cyber  ->  plore
cyc  ->  plp
cyd  ->  plq
cyf  ->  pls
cyff  ->  plss
cym  ->  plz
cyn  ->  pla
cyna  ->  plan
cynane  ->  planar
cynara  ->  planen
cyng  ->  plat
cyni  ->  plav
cyning  ->  plavat
cynion  ->  plavba
cynon  ->  plaba
cynt  ->  plag
cyo  ->  plb
cyp  ->  plc
cyr  ->  ple
cyran  ->  plena
cyrc  ->  plep
cyre  ->  pler
cyren  ->  plera
cyrf  ->  ples
cyrff  ->  pless
cyri  ->  plev
cyril  ->  plevy
cyrk  ->  plex
cyrl  ->  pley
cyrn  ->  plea
cyro  ->  pleb
cyrr  ->  plee
cys  ->  plf
cyve  ->  plir
cz  ->  pm
cze  ->  pmr
czt  ->  pmg
czuk  ->  pmhx
czy  ->  pml
d  ->  q
da  ->  qn
dag  ->  qnt
daj  ->  qnw
dao  ->  qnb
daog  ->  qnbt
daq  ->  qnd
dar  ->  qne
daru  ->  qneh
dau  ->  qnh
daw  ->  qnj
dawg  ->  qnjt
db  ->  qo
dba  ->  qon
dbc  ->  qop
dbd  ->  qoq
dbe  ->  qor
dbf  ->  qos
dbm  ->  qoz
dbn  ->  qoa
dbq  ->  qod
dbs  ->  qof
dcc  ->  qpp
dce  ->  qpr
dcs  ->  qpf
dd  ->  qq
dda  ->  qqn
de  ->  qr
dea  ->  qrn
deb  ->  qro
dec  ->  qrp
decre  ->  qrper
ded  ->  qrq
dee  ->  qrr
deeg  ->  qrrt
def  ->  qrs
deff  ->  qrss
deg  ->  qrt
deh  ->  qru
deha  ->  qrun
dei  ->  qrv
dej  ->  qrw
dek  ->  qrx
dem  ->  qrz
den  ->  qra
deny  ->  qral
des  ->  qrf
desg  ->  qrft
det  ->  qrg
deu  ->  qrh
dev  ->  qri
devo  ->  qrib
dew  ->  qrj
dex  ->  qrk
dey  ->  qrl
dez  ->  qrm
df  ->  qs
dfa  ->  qsn
dfb  ->  qso
dfc  ->  qsp
dfe  ->  qsr
dfl  ->  qsy
dfm  ->  qsz
dft  ->  qsg
dfv  ->  qsi
dg  ->  qt
dgb  ->  qto
dgm  ->  qtz
dgn  ->  qta
dgs  ->  qtf
dgy  ->  qtl
dh  ->  qu
dh'  ->  qu'
dha  ->  qun
dhap  ->  qunc
dhe  ->  qur
dheg  ->  qurt
dheh  ->  quru
dhez  ->  qurm
dhnt  ->  quag
dho  ->  qub
dhoor  ->  qubbe
dhp  ->  quc
dhr  ->  que
dhre  ->  quer
dhs  ->  quf
dhub  ->  quho
dhura  ->  quhen
dhv  ->  qui
dhz  ->  qum
di  ->  qv
dig  ->  qvt
dine  ->  qvar
diy  ->  qvl
dle  ->  qyr
dlr  ->  qye
dly  ->  qyl
dn  ->  qa
dna  ->  qan
dnc  ->  qap
dnd  ->  qaq
dne  ->  qar
dnem  ->  qarz
dnf  ->  qas
dng  ->  qat
dnh  ->  qau
dno  ->  qab
dnp  ->  qac
dnq  ->  qad
dnu  ->  qah
dnw  ->  qaj
dny  ->  qal
dnz  ->  qam
do  ->  qb
dob  ->  qbo
dof  ->  qbs
dog  ->  qbt
doj  ->  qbw
doo  ->  qbb
doq  ->  qbd
dou  ->  qbh
dp  ->  qc
dppd  ->  qccq
dq  ->  qd
dr  ->  qe
dra  ->  qen
draf  ->  qens
drar  ->  qene
dray  ->  qenl
drc  ->  qep
dreg  ->  qert
dres  ->  qerf
drl  ->  qey
drp  ->  qec
drs  ->  qef
druor  ->  qehbe
drus  ->  qehf
drws  ->  qejf
dry  ->  qel
dryg  ->  qelt
dryn  ->  qela
dsr  ->  qfe
dt  ->  qg
dtc  ->  qgp
dtf  ->  qgs
dtn  ->  qga
du  ->  qh
dubi  ->  qhov
dug  ->  qht
duhen  ->  qhura
duhni  ->  qhuav
duhon  ->  qhuba
dun  ->  qha
dunc  ->  qhap
dundun  ->  qhaqha
dung  ->  qhat
dungun  ->  qhatha
dunon  ->  qhaba
duq  ->  qhd
duvan  ->  qhina
duy  ->  qhl
dv  ->  qi
dva  ->  qin
dvb  ->  qio
dvm  ->  qiz
dvr  ->  qie
dy  ->  ql
dyp  ->  qlc
dz  ->  qm
e  ->  r
e'  ->  r'
'e  ->  'r
ea  ->  rn
eaa  ->  rnn
eac  ->  rnp
eae  ->  rnr
eaf  ->  rns
ean  ->  rna
eao  ->  rnb
eap  ->  rnc
ear  ->  rne
eat  ->  rng
eav  ->  rni
eb  ->  ro
eba  ->  ron
eban  ->  rona
ebarb  ->  roneo
ebb  ->  roo
ebba  ->  roon
ebbe  ->  roor
ebbi  ->  roov
ebbs  ->  roof
ebbt  ->  roog
ebbw  ->  rooj
ebe  ->  ror
ebel  ->  rory
eben  ->  rora
ebenan  ->  rorana
ebener  ->  rorare
ebenere  ->  rorarer
ebenerer  ->  rorarere
eber  ->  rore
ebere  ->  rorer
ebi  ->  rov
ebibe  ->  rovor
ebin  ->  rova
ebk  ->  rox
ebl  ->  roy
eblan  ->  royna
ebm  ->  roz
ebn  ->  roa
ebne  ->  roar
ebnen  ->  roara
ebner  ->  roare
ebob  ->  robo
ebol  ->  roby
ebola  ->  robyn
ebon  ->  roba
ebony  ->  robal
ebor  ->  robe
ebora  ->  roben
ebore  ->  rober
ebov  ->  robi
ebq  ->  rod
ebra  ->  roen
ebre  ->  roer
ebs  ->  rof
ebu  ->  roh
ebur  ->  rohe
ebura  ->  rohen
ebuy  ->  rohl
ebv  ->  roi
ebw  ->  roj
eby  ->  rol
ebyr  ->  role
ebys  ->  rolf
ec  ->  rp
eca  ->  rpn
ecb  ->  rpo
ecc  ->  rpp
ecg  ->  rpt
eci  ->  rpv
ecmo  ->  rpzb
ecp  ->  rpc
ecs  ->  rpf
ect  ->  rpg
ecu  ->  rph
ecx  ->  rpk
edd  ->  rqq
edn  ->  rqa
ee  ->  rr
eean  ->  rrna
eec  ->  rrp
eef  ->  rrs
eeg  ->  rrt
een  ->  rra
eent  ->  rrag
eer  ->  rre
eerl  ->  rrey
eers  ->  rref
eeuu  ->  rrhh
eev  ->  rri
eew  ->  rrj
ef  ->  rs
efa  ->  rsn
efb  ->  rso
eff  ->  rss
efi  ->  rsv
efor  ->  rsbe
efp  ->  rsc
efs  ->  rsf
eft  ->  rsg
efu  ->  rsh
efv  ->  rsi
eg  ->  rt
ega  ->  rtn
ege  ->  rtr
egg  ->  rtt
egi  ->  rtv
egl  ->  rty
egn  ->  rta
ego  ->  rtb
egp  ->  rtc
egr  ->  rte
egs  ->  rtf
egt  ->  rtg
egy  ->  rtl
eh  ->  ru
eha  ->  run
ehal  ->  runy
ehc  ->  rup
ehe  ->  rur
ehec  ->  rurp
ehen  ->  rura
eher  ->  rure
ehh  ->  ruu
ehi  ->  ruv
ehing  ->  ruvat
ehir  ->  ruve
ehla  ->  ruyn
ehm  ->  ruz
eho  ->  rub
ehon  ->  ruba
ehp  ->  ruc
ehpu  ->  ruch
ehr  ->  rue
ehre  ->  ruer
ehren  ->  ruera
ehrt  ->  rueg
ehs  ->  ruf
eht  ->  rug
ehte  ->  rugr
ehtne  ->  rugar
ehun  ->  ruha
ehz  ->  rum
ei  ->  rv
eia  ->  rvn
eib  ->  rvo
eic  ->  rvp
eici  ->  rvpv
eii  ->  rvv
ein  ->  rva
eina  ->  rvan
eio  ->  rvb
eis  ->  rvf
eiu  ->  rvh
ej  ->  rw
ejb  ->  rwo
ek  ->  rx
eka  ->  rxn
eke  ->  rxr
el  ->  ry
ela  ->  ryn
elar  ->  ryne
elb  ->  ryo
elba  ->  ryon
elban  ->  ryona
elc  ->  ryp
ele  ->  ryr
eler  ->  ryre
elf  ->  rys
elfr  ->  ryse
elfu  ->  rysh
elg  ->  ryt
elge  ->  rytr
elgr  ->  ryte
elh  ->  ryu
elin  ->  ryva
elir  ->  ryve
eln  ->  rya
elna  ->  ryan
elo  ->  ryb
elon  ->  ryba
elone  ->  rybar
elp  ->  ryc
elr  ->  rye
elt  ->  ryg
elun  ->  ryha
elv  ->  ryi
elva  ->  ryin
elw  ->  ryj
elwn  ->  ryja
elx  ->  ryk
ely  ->  ryl
elyn  ->  ryla
em  ->  rz
eml  ->  rzy
emn  ->  rza
emr  ->  rze
en  ->  ra
ena  ->  ran
enaa  ->  rann
enaba  ->  ranon
enal  ->  rany
enam  ->  ranz
enan  ->  rana
enanu  ->  ranah
enap  ->  ranc
enar  ->  rane
enat  ->  rang
enate  ->  rangr
enba  ->  raon
enby  ->  raol
enc  ->  rap
ench  ->  rapu
encha  ->  rapun
encra  ->  rapen
encre  ->  raper
encrer  ->  rapere
encur  ->  raphe
end  ->  raq
endon  ->  raqba
ene  ->  rar
enen  ->  rara
ener  ->  rare
enere  ->  rarer
enes  ->  rarf
enf  ->  ras
enfi  ->  rasv
enfin  ->  rasva
enfla  ->  rasyn
enfrene  ->  raserar
enfyn  ->  rasla
eng  ->  rat
engan  ->  ratna
enganchen  ->  ratnapura
enger  ->  ratre
engh  ->  ratu
engr  ->  rate
engra  ->  raten
engrar  ->  ratene
engu  ->  rath
engur  ->  rathe
engyl  ->  ratly
engyn  ->  ratla
eni  ->  rav
enif  ->  ravs
eniha  ->  ravun
enin  ->  rava
enina  ->  ravan
enivre  ->  ravier
enj  ->  raw
enja  ->  rawn
enk  ->  rax
enl  ->  ray
enm  ->  raz
enma  ->  razn
enmu  ->  razh
enn  ->  raa
enna  ->  raan
enne  ->  raar
ennen  ->  raara
enner  ->  raare
enni  ->  raav
enno  ->  raab
ennog  ->  raabt
enns  ->  raaf
enny  ->  raal
eno  ->  rab
enol  ->  raby
enon  ->  raba
enona  ->  raban
enone  ->  rabar
enor  ->  rabe
enorer  ->  rabere
enpyre  ->  racler
ens  ->  raf
ent  ->  rag
enta  ->  ragn
entan  ->  ragna
ente  ->  ragr
entf  ->  rags
entra  ->  ragen
entre  ->  rager
entren  ->  ragera
entry  ->  ragel
enu  ->  rah
enua  ->  rahn
enuan  ->  rahna
enuba  ->  rahon
enuf  ->  rahs
enuh  ->  rahu
enuon  ->  rahba
envar  ->  raine
envara  ->  rainen
envare  ->  rainer
envaren  ->  rainera
envy  ->  rail
enw  ->  raj
eny  ->  ral
enyne  ->  ralar
enyora  ->  ralben
enys  ->  ralf
enyv  ->  rali
enyvrer  ->  raliere
enz  ->  ram
enza  ->  ramn
enzan  ->  ramna
enzo  ->  ramb
eo  ->  rb
eoc  ->  rbp
eod  ->  rbq
eof  ->  rbs
eog  ->  rbt
eol  ->  rby
eon  ->  rba
eone  ->  rbar
eop  ->  rbc
eos  ->  rbf
eot  ->  rbg
ep  ->  rc
epa  ->  rcn
epc  ->  rcp
epg  ->  rct
eph  ->  rcu
epns  ->  rcaf
epoc  ->  rcbp
epp  ->  rcc
epq  ->  rcd
epr  ->  rce
epu  ->  rch
eq  ->  rd
eqp  ->  rdc
eqs  ->  rdf
er  ->  re
'er  ->  're
era  ->  ren
eraan  ->  renna
eraf  ->  rens
erag  ->  rent
eral  ->  reny
eram  ->  renz
eran  ->  rena
erana  ->  renan
erang  ->  renat
erare  ->  rener
erat  ->  reng
erava  ->  renin
erb  ->  reo
erba  ->  reon
erbam  ->  reonz
erbat  ->  reong
erbe  ->  reor
erbet  ->  reorg
erby  ->  reol
erc  ->  rep
erch  ->  repu
erchan  ->  repuna
erd  ->  req
ere  ->  rer
eren  ->  rera
erer  ->  rere
erf  ->  res
erfar  ->  resne
erfc  ->  resp
erfin  ->  resva
erfrag  ->  resent
erfu  ->  resh
erfyn  ->  resla
erg  ->  ret
erga  ->  retn
erger  ->  retre
ergh  ->  retu
ergra  ->  reten
ergre  ->  reter
erhan  ->  reuna
eri  ->  rev
erian  ->  revna
eril  ->  revy
erile  ->  revyr
erill  ->  revyy
erin  ->  reva
erina  ->  revan
erine  ->  revar
erinev  ->  revari
erk  ->  rex
erki  ->  rexv
erl  ->  rey
erla  ->  reyn
erlab  ->  reyno
erlan  ->  reyna
erle  ->  reyr
erli  ->  reyv
erlir  ->  reyve
erm  ->  rez
ermr  ->  reze
ern  ->  rea
erna  ->  rean
ernaar  ->  reanne
erne  ->  rear
erneq  ->  reard
ernir  ->  reave
erns  ->  reaf
ero  ->  reb
erober  ->  rebore
erobre  ->  reboer
erobrer  ->  reboere
eroev  ->  rebri
erof  ->  rebs
eron  ->  reba
eror  ->  rebe
erp  ->  rec
erpf  ->  recs
erprob  ->  recebo
err  ->  ree
erra  ->  reen
errara  ->  reenen
erre  ->  reer
errer  ->  reere
erro  ->  reeb
errs  ->  reef
ers  ->  ref
erse  ->  refr
ersh  ->  refu
ersna  ->  refan
ersyn  ->  refla
ert  ->  reg
erta  ->  regn
ertag  ->  regnt
ertan  ->  regna
erten  ->  regra
ertene  ->  regrar
erth  ->  regu
erthe  ->  regur
erthyn  ->  regula
ertr  ->  rege
ertra  ->  regen
ertrag  ->  regent
eru  ->  reh
eruar  ->  rehne
erub  ->  reho
erui  ->  rehv
erung  ->  rehat
eruv  ->  rehi
erv  ->  rei
erva  ->  rein
ervan  ->  reina
ervare  ->  reiner
erve  ->  reir
erven  ->  reira
ervi  ->  reiv
ervin  ->  reiva
ervs  ->  reif
erw  ->  rej
ery  ->  rel
eryl  ->  rely
eryr  ->  rele
erz  ->  rem
erzne  ->  remar
erznen  ->  remara
erzner  ->  remare
es  ->  rf
esc  ->  rfp
esd  ->  rfq
esf  ->  rfs
esg  ->  rft
esi  ->  rfv
esk  ->  rfx
esn  ->  rfa
eso  ->  rfb
esp  ->  rfc
esq  ->  rfd
esr  ->  rfe
esrf  ->  rfes
esv  ->  rfi
et  ->  rg
etf  ->  rgs
etl  ->  rgy
eto  ->  rgb
eu  ->  rh
eua  ->  rhn
euh  ->  rhu
eul  ->  rhy
eun  ->  rha
euna  ->  rhan
eunt  ->  rhag
eura  ->  rhen
eus  ->  rhf
eut  ->  rhg
euv  ->  rhi
ev  ->  ri
eva  ->  rin
evan  ->  rina
evap  ->  rinc
evar  ->  rine
evat  ->  ring
evax  ->  rink
evc  ->  rip
eve  ->  rir
even  ->  rira
ever  ->  rire
evf  ->  ris
evi  ->  riv
evin  ->  riva
evina  ->  rivan
evine  ->  rivar
evira  ->  riven
evirer  ->  rivere
evle  ->  riyr
evm  ->  riz
evn  ->  ria
evna  ->  rian
evne  ->  riar
evo  ->  rib
evon  ->  riba
evoo  ->  ribb
evor  ->  ribe
evora  ->  riben
evoren  ->  ribera
evp  ->  ric
evra  ->  rien
evren  ->  riera
evro  ->  rieb
evrur  ->  riehe
evry  ->  riel
evs  ->  rif
evt  ->  rig
evu  ->  rih
evvk  ->  riix
evy  ->  ril
evyl  ->  rily
ew  ->  rj
ex  ->  rk
exy  ->  rkl
ey  ->  rl
eye  ->  rlr
eyi  ->  rlv
eyr  ->  rle
ez  ->  rm
eza  ->  rmn
ezb  ->  rmo
ezh  ->  rmu
ezo  ->  rmb
f  ->  s
f'  ->  s'
fa  ->  sn
fab  ->  sno
faba  ->  snon
fabby  ->  snool
fabe  ->  snor
fabel  ->  snory
fabela  ->  snoryn
faber  ->  snore
fabere  ->  snorer
fabo  ->  snob
fabon  ->  snoba
fabor  ->  snobe
fabre  ->  snoer
fabs  ->  snof
fac  ->  snp
fad  ->  snq
fae  ->  snr
faef  ->  snrs
fag  ->  snt
fagy  ->  sntl
fah  ->  snu
fahr  ->  snue
fahs  ->  snuf
fal  ->  sny
falr  ->  snye
fan  ->  sna
fane  ->  snar
faneg  ->  snart
fanel  ->  snary
fanen  ->  snara
faner  ->  snare
fanera  ->  snaren
fanes  ->  snarf
fang  ->  snat
fangu  ->  snath
fanh  ->  snau
fanne  ->  snaar
fano  ->  snab
fant  ->  snag
fanun  ->  snaha
fanz  ->  snam
fao  ->  snb
faps  ->  sncf
faq  ->  snd
far  ->  sne
fara  ->  snen
farat  ->  sneng
farb  ->  sneo
farba  ->  sneon
fare  ->  sner
fareen  ->  snerra
farg  ->  snet
farn  ->  snea
faro  ->  sneb
farr  ->  snee
farra  ->  sneen
farre  ->  sneer
farrel  ->  sneery
fart  ->  sneg
farty  ->  snegl
faru  ->  sneh
fary  ->  snel
fas  ->  snf
fase  ->  snfr
fat  ->  sng
fate  ->  sngr
fatv  ->  sngi
fav  ->  sni
fava  ->  snin
favi  ->  sniv
favo  ->  snib
favs  ->  snif
faw  ->  snj
fay  ->  snl
fayr  ->  snle
faz  ->  snm
fb  ->  so
fbc  ->  sop
fbh  ->  sou
fbi  ->  sov
fbier  ->  sovre
fbo  ->  sob
fbq  ->  sod
fbr  ->  soe
fbrs  ->  soef
fbs  ->  sof
fbss  ->  soff
fbt  ->  sog
fbw  ->  soj
fc  ->  sp
fca  ->  spn
fcb  ->  spo
fcbs  ->  spof
fcc  ->  spp
fce  ->  spr
fcf  ->  sps
fcm  ->  spz
fcn  ->  spa
fco  ->  spb
fcp  ->  spc
fcra  ->  spen
fcs  ->  spf
fct  ->  spg
fcu  ->  sph
fcv  ->  spi
fcy  ->  spl
fd  ->  sq
fda  ->  sqn
fde  ->  sqr
fdg  ->  sqt
fdi  ->  sqv
fdq  ->  sqd
fe  ->  sr
fean  ->  srna
feb  ->  sro
fec  ->  srp
fedj  ->  srqw
fee  ->  srr
feg  ->  srt
fegn  ->  srta
feh  ->  sru
fei  ->  srv
fej  ->  srw
fel  ->  sry
fen  ->  sra
fenan  ->  srana
fenar  ->  srane
fenc  ->  srap
fengu  ->  srath
feno  ->  srab
fenu  ->  srah
fenyl  ->  sraly
fenyn  ->  srala
fenz  ->  sram
feo  ->  srb
fep  ->  src
fer  ->  sre
ferf  ->  sres
fern  ->  srea
feron  ->  sreba
fes  ->  srf
feu  ->  srh
fev  ->  sri
fevna  ->  srian
few  ->  srj
fex  ->  srk
fey  ->  srl
fez  ->  srm
ff  ->  ss
ffa  ->  ssn
ffb  ->  sso
fff  ->  sss
ffo  ->  ssb
ffoaf  ->  ssbns
ffoo  ->  ssbb
ffp  ->  ssc
ffr  ->  sse
ffrs  ->  ssef
ffs  ->  ssf
fft  ->  ssg
ffurf  ->  sshes
ffv  ->  ssi
ffy  ->  ssl
fg  ->  st
fgc  ->  stp
fgf  ->  sts
fgi  ->  stv
fgn  ->  sta
fgs  ->  stf
fgy  ->  stl
fh  ->  su
fha  ->  sun
fhan  ->  suna
fhc  ->  sup
fhd  ->  suq
fhg  ->  sut
fhif  ->  suvs
fhir  ->  suve
fho  ->  sub
fhr  ->  sue
fhs  ->  suf
fhyne  ->  sular
fhz  ->  sum
fi  ->  sv
fia  ->  svn
fib  ->  svo
fiban  ->  svona
fiber  ->  svore
fic  ->  svp
fid  ->  svq
fie  ->  svr
fieno  ->  svrab
fif  ->  svs
fig  ->  svt
fila  ->  svyn
fim  ->  svz
fin  ->  sva
fina  ->  svan
finan  ->  svana
finar  ->  svane
finara  ->  svanen
finare  ->  svaner
finate  ->  svangr
fine  ->  svar
finegan  ->  svartna
finegr  ->  svarte
finei  ->  svarv
finen  ->  svara
finer  ->  svare
finere  ->  svarer
finez  ->  svarm
fing  ->  svat
fingr  ->  svate
fini  ->  svav
finne  ->  svaar
fins  ->  svaf
fint  ->  svag
finu  ->  svah
fip  ->  svc
fir  ->  sve
fira  ->  sven
firan  ->  svena
firaq  ->  svend
firav  ->  sveni
fire  ->  sver
firet  ->  sverg
firi  ->  svev
firin  ->  sveva
firir  ->  sveve
firn  ->  svea
firt  ->  sveg
fit  ->  svg
fiv  ->  svi
fiva  ->  svin
five  ->  svir
fiver  ->  svire
fix  ->  svk
fiz  ->  svm
fj  ->  sw
fjc  ->  swp
fjs  ->  swf
fk  ->  sx
fks  ->  sxf
fl  ->  sy
fla  ->  syn
flab  ->  syno
flag  ->  synt
flagu  ->  synth
flah  ->  synu
flan  ->  syna
flane  ->  synar
flang  ->  synat
flap  ->  sync
flarar  ->  synene
flare  ->  syner
flarf  ->  synes
flashy  ->  synful
flat  ->  syng
flate  ->  syngr
flative  ->  syngvir
flatr  ->  synge
flattre  ->  syngger
flave  ->  synir
flawn  ->  synja
flax  ->  synk
flc  ->  syp
fle  ->  syr
fleane  ->  syrnar
fleen  ->  syrra
fleg  ->  syrt
flek  ->  syrx
flen  ->  syra
flena  ->  syran
flene  ->  syrar
flenu  ->  syrah
fler  ->  syre
flera  ->  syren
flere  ->  syrer
fleu  ->  syrh
flex  ->  syrk
fli  ->  syv
flir  ->  syve
flk  ->  syx
fln  ->  sya
flob  ->  sybo
floor  ->  sybbe
fls  ->  syf
flt  ->  syg
flu  ->  syh
flun  ->  syha
flx  ->  syk
fly  ->  syl
flyg  ->  sylt
flyj  ->  sylw
flyr  ->  syle
flys  ->  sylf
flyv  ->  syli
flyyn  ->  sylla
fm  ->  sz
fmj  ->  szw
fml  ->  szy
fmn  ->  sza
fmr  ->  sze
fmvs  ->  szif
fn  ->  sa
fna  ->  san
fnaf  ->  sans
fnar  ->  sane
fnarr  ->  sanee
fnc  ->  sap
fnd  ->  saq
fng  ->  sat
fnora  ->  saben
fnp  ->  sac
fnq  ->  sad
fns  ->  saf
fnu  ->  sah
fnug  ->  saht
fnv  ->  sai
fnys  ->  salf
fo  ->  sb
foa  ->  sbn
foba  ->  sbon
fobt  ->  sbog
fod  ->  sbq
fogl  ->  sbty
foh  ->  sbu
fok  ->  sbx
fol  ->  sby
fon  ->  sba
fona  ->  sban
fone  ->  sbar
fop  ->  sbc
for  ->  sbe
fore  ->  sber
foreyn  ->  sberla
fory  ->  sbel
fos  ->  sbf
fou  ->  sbh
fov  ->  sbi
fove  ->  sbir
fow  ->  sbj
fox  ->  sbk
foz  ->  sbm
fp  ->  sc
fpa  ->  scn
fpb  ->  sco
fpc  ->  scp
fpm  ->  scz
fpn  ->  sca
fpns  ->  scaf
fpo  ->  scb
fps  ->  scf
fpu  ->  sch
fpv  ->  sci
fqt  ->  sdg
fr  ->  se
fra  ->  sen
fraa  ->  senn
fraar  ->  senne
frab  ->  seno
frac  ->  senp
frag  ->  sent
fragen  ->  sentra
fragra  ->  senten
frah  ->  senu
frail  ->  senvy
fral  ->  seny
fram  ->  senz
framhev  ->  senzuri
fran  ->  sena
frana  ->  senan
franc  ->  senap
frane  ->  senar
frang  ->  senat
frangar  ->  senatne
franz  ->  senam
frapu  ->  sench
fraq  ->  send
frar  ->  sene
frare  ->  sener
fras  ->  senf
frat  ->  seng
frater  ->  sengre
fratre  ->  senger
frau  ->  senh
fraw  ->  senj
frb  ->  seo
frc  ->  sep
frd  ->  seq
fre  ->  ser
frean  ->  serna
freba  ->  seron
frec  ->  serp
fred  ->  serq
free  ->  serr
freel  ->  serry
freen  ->  serra
freer  ->  serre
freere  ->  serrer
fregn  ->  serta
fregne  ->  sertar
freh  ->  seru
freht  ->  serug
frei  ->  serv
frein  ->  serva
freine  ->  servar
freiner  ->  servare
freing  ->  servat
freir  ->  serve
freira  ->  serven
freire  ->  server
fremu  ->  serzh
fren  ->  sera
frena  ->  seran
frenat  ->  serang
frend  ->  seraq
frene  ->  serar
frener  ->  serare
frenere  ->  serarer
freng  ->  serat
frens  ->  seraf
frenu  ->  serah
freo  ->  serb
freoh  ->  serbu
freon  ->  serba
freonin  ->  serbava
freor  ->  serbe
freq  ->  serd
frer  ->  sere
frere  ->  serer
fres  ->  serf
fret  ->  serg
fretu  ->  sergh
frex  ->  serk
frexh  ->  serku
freyr  ->  serle
frez  ->  serm
frf  ->  ses
frg  ->  set
fri  ->  sev
frib  ->  sevo
frier  ->  sevre
friere  ->  sevrer
frieren  ->  sevrera
frila  ->  sevyn
frin  ->  seva
frina  ->  sevan
frir  ->  seve
frire  ->  sever
frj  ->  sew
frl  ->  sey
frls  ->  seyf
fro  ->  seb
frob  ->  sebo
frod  ->  sebq
froe  ->  sebr
froen  ->  sebra
froh  ->  sebu
fron  ->  seba
frond  ->  sebaq
fronk  ->  sebax
fror  ->  sebe
frover  ->  sebire
frp  ->  sec
frs  ->  sef
frta  ->  segn
fru  ->  seh
frua  ->  sehn
fruar  ->  sehne
frue  ->  sehr
fruen  ->  sehra
frug  ->  seht
frun  ->  seha
frws  ->  sejf
fry  ->  sel
frye  ->  selr
frys  ->  self
fryt  ->  selg
fryth  ->  selgu
fs  ->  sf
fsb  ->  sfo
fsc  ->  sfp
fsf  ->  sfs
fsk  ->  sfx
fsm  ->  sfz
fsn  ->  sfa
fst  ->  sfg
fsv  ->  sfi
ft  ->  sg
fta  ->  sgn
ftaa  ->  sgnn
ftc  ->  sgp
fte  ->  sgr
fto  ->  sgb
ftp  ->  sgc
ftr  ->  sge
fu  ->  sh
fua  ->  shn
fub  ->  sho
fubar  ->  shone
fubby  ->  shool
fubs  ->  shof
fubu  ->  shoh
fuc  ->  shp
fuen  ->  shra
fug  ->  sht
fugero  ->  shtreb
fugle  ->  shtyr
fugs  ->  shtf
fuh  ->  shu
fuhr  ->  shue
fuht  ->  shug
fuig  ->  shvt
fuin  ->  shva
ful  ->  shy
fula  ->  shyn
fular  ->  shyne
fulg  ->  shyt
fun  ->  sha
funa  ->  shan
funan  ->  shana
funar  ->  shane
funare  ->  shaner
funat  ->  shang
func  ->  shap
fund  ->  shaq
fune  ->  shar
funen  ->  shara
funere  ->  sharer
funez  ->  sharm
funfun  ->  shasha
fung  ->  shat
fungare  ->  shatner
fungh  ->  shatu
funi  ->  shav
funin  ->  shava
funj  ->  shaw
funja  ->  shawn
funjan  ->  shawna
funn  ->  shaa
funna  ->  shaan
funo  ->  shab
funt  ->  shag
funz  ->  sham
fuon  ->  shba
fuot  ->  shbg
fuq  ->  shd
fur  ->  she
fura  ->  shen
furan  ->  shena
furat  ->  sheng
furax  ->  shenk
furby  ->  sheol
fure  ->  sher
furen  ->  shera
furene  ->  sherar
furer  ->  shere
furere  ->  sherer
furh  ->  sheu
furin  ->  sheva
furl  ->  shey
furna  ->  shean
furne  ->  shear
furner  ->  sheare
furnir  ->  sheave
furo  ->  sheb
furon  ->  sheba
furono  ->  shebab
furorna  ->  shebean
furr  ->  shee
furrfu  ->  sheesh
furry  ->  sheel
furs  ->  shef
furur  ->  shehe
furz  ->  shem
furzo  ->  shemb
fus  ->  shf
fut  ->  shg
fuvu  ->  shih
fuz  ->  shm
fv  ->  si
fvf  ->  sis
fvh  ->  siu
fvrin  ->  sieva
fvw  ->  sij
fw  ->  sj
fwa  ->  sjn
fwb  ->  sjo
fwf  ->  sjs
fwh  ->  sju
fwhs  ->  sjuf
fwj  ->  sjw
fws  ->  sjf
fx  ->  sk
fy  ->  sl
fycz  ->  slpm
fye  ->  slr
fyef  ->  slrs
fyf  ->  sls
fyi  ->  slv
fyl  ->  sly
fylan  ->  slyna
fyn  ->  sla
fyngre  ->  slater
fynt  ->  slag
fyr  ->  sle
fyrat  ->  sleng
fyri  ->  slev
fyrir  ->  sleve
fyrna  ->  slean
fyrr  ->  slee
fyrre  ->  sleer
fyrs  ->  slef
fyrt  ->  sleg
fyt  ->  slg
fyve  ->  slir
fz  ->  sm
g  ->  t
g'  ->  t'
ga  ->  tn
gaa  ->  tnn
gab  ->  tno
gabh  ->  tnou
gae  ->  tnr
gaf  ->  tns
gag  ->  tnt
gah  ->  tnu
gaha  ->  tnun
gaj  ->  tnw
gak  ->  tnx
gan  ->  tna
gank  ->  tnax
gann  ->  tnaa
gao  ->  tnb
gap  ->  tnc
gar  ->  tne
gars  ->  tnef
garwa  ->  tnejn
gary  ->  tnel
gas  ->  tnf
gat  ->  tng
gav  ->  tni
gavr  ->  tnie
gaw  ->  tnj
gay  ->  tnl
gaya  ->  tnln
gaz  ->  tnm
gb  ->  to
gba  ->  ton
gban  ->  tona
gbb  ->  too
gbc  ->  top
gbcs  ->  topf
gbe  ->  tor
gbf  ->  tos
gbg  ->  tot
gbh  ->  tou
gbi  ->  tov
gbin  ->  tova
gbl  ->  toy
gble  ->  toyr
gbn  ->  toa
gbp  ->  toc
gbq  ->  tod
gbr  ->  toe
gbra  ->  toen
gbs  ->  tof
gbu  ->  toh
gbv  ->  toi
gbx  ->  tok
gc  ->  tp
gcb  ->  tpo
gcc  ->  tpp
gce  ->  tpr
gcf  ->  tps
gci  ->  tpv
gcn  ->  tpa
gcp  ->  tpc
gcr  ->  tpe
gcs  ->  tpf
gd  ->  tq
ge  ->  tr
gea  ->  trn
gean  ->  trna
geanin  ->  trnava
geb  ->  tro
geba  ->  tron
gebaar  ->  tronne
geban  ->  trona
gebar  ->  trone
gebare  ->  troner
gebaren  ->  tronera
gebat  ->  trong
gebe  ->  tror
gebebt  ->  trorog
gebrar  ->  troene
gebre  ->  troer
gebs  ->  trof
gebt  ->  trog
gebun  ->  troha
gebyr  ->  trole
gec  ->  trp
gef  ->  trs
geg  ->  trt
geh  ->  tru
geha  ->  trun
gehan  ->  truna
gehat  ->  trung
gehe  ->  trur
gehir  ->  truve
gehl  ->  truy
gehn  ->  trua
geho  ->  trub
gehon  ->  truba
gehr  ->  true
geht  ->  trug
gei  ->  trv
gel  ->  try
gela  ->  tryn
gelan  ->  tryna
gelar  ->  tryne
gelara  ->  trynen
gelare  ->  tryner
gelg  ->  tryt
gelo  ->  tryb
gelon  ->  tryba
gelor  ->  trybe
gelre  ->  tryer
gelt  ->  tryg
geltir  ->  trygve
gemba  ->  trzon
gen  ->  tra
gena  ->  tran
genad  ->  tranq
genap  ->  tranc
genar  ->  trane
genare  ->  traner
genat  ->  trang
genau  ->  tranh
genc  ->  trap
gene  ->  trar
genear  ->  trarne
genf  ->  tras
geng  ->  trat
gengr  ->  trate
gengu  ->  trath
geni  ->  trav
genin  ->  trava
genk  ->  trax
genna  ->  traan
geno  ->  trab
genog  ->  trabt
genon  ->  traba
genre  ->  traer
gens  ->  traf
gent  ->  trag
gentner  ->  tragare
genug  ->  traht
genune  ->  trahar
genung  ->  trahat
genunk  ->  trahax
genver  ->  traire
genz  ->  tram
geo  ->  trb
gep  ->  trc
geq  ->  trd
ger  ->  tre
gera  ->  tren
geraf  ->  trens
gerah  ->  trenu
geral  ->  treny
geranin  ->  trenava
gerar  ->  trene
gerara  ->  trenen
gerare  ->  trener
gerat  ->  treng
gerava  ->  trenin
gerb  ->  treo
gerbe  ->  treor
gere  ->  trer
gerha  ->  treun
geri  ->  trev
gerin  ->  treva
gerira  ->  treven
gerla  ->  treyn
germ  ->  trez
gern  ->  trea
gero  ->  treb
geron  ->  treba
gerr  ->  tree
gerra  ->  treen
gers  ->  tref
gersh  ->  trefu
gert  ->  treg
gervi  ->  treiv
ges  ->  trf
get  ->  trg
geto  ->  trgb
geu  ->  trh
geung  ->  trhat
gev  ->  tri
geva  ->  trin
gevan  ->  trina
gevat  ->  tring
geve  ->  trir
gevir  ->  trive
gevira  ->  triven
gevirer  ->  trivere
gevra  ->  trien
gewr  ->  trje
gey  ->  trl
gf  ->  ts
gfc  ->  tsp
gfcf  ->  tsps
gfe  ->  tsr
gfi  ->  tsv
gfo  ->  tsb
gfp  ->  tsc
gfr  ->  tse
gfs  ->  tsf
gfu  ->  tsh
gfx  ->  tsk
gfy  ->  tsl
gg  ->  tt
gge  ->  ttr
ggg  ->  ttt
ggl  ->  tty
ggt  ->  ttg
ggy  ->  ttl
gh  ->  tu
gha  ->  tun
ghaa  ->  tunn
ghaan  ->  tunna
ghabh  ->  tunou
ghagra  ->  tunten
ghal  ->  tuny
ghan  ->  tuna
ghana  ->  tunan
ghar  ->  tune
ghara  ->  tunen
gharr  ->  tunee
ghat  ->  tung
ghayn  ->  tunla
ghb  ->  tuo
ghe  ->  tur
gheare  ->  turner
ghearr  ->  turnee
gheb  ->  turo
ghebi  ->  turov
ghee  ->  turr
gheen  ->  turra
gheg  ->  turt
gheghe  ->  turtur
gheibh  ->  turvou
ghen  ->  tura
ghene  ->  turar
gheorghe  ->  turbetur
ghera  ->  turen
ghere  ->  turer
gherra  ->  tureen
ghg  ->  tut
ghi  ->  tuv
ghih  ->  tuvu
ghin  ->  tuva
ghine  ->  tuvar
gho  ->  tub
ghob  ->  tubo
ghong  ->  tubat
ghor  ->  tube
ghora  ->  tuben
ghorm  ->  tubez
ghq  ->  tud
ghs  ->  tuf
ghu  ->  tuh
ghuba  ->  tuhon
ghz  ->  tum
gi  ->  tv
giam  ->  tvnz
gib  ->  tvo
gibe  ->  tvor
gibel  ->  tvory
giben  ->  tvora
giber  ->  tvore
gic  ->  tvp
gid  ->  tvq
gie  ->  tvr
gif  ->  tvs
gigo  ->  tvtb
gij  ->  tvw
gin  ->  tva
ginat  ->  tvang
gine  ->  tvar
ginen  ->  tvara
ginere  ->  tvarer
gio  ->  tvb
gip  ->  tvc
gipe  ->  tvcr
gir  ->  tve
gire  ->  tver
girl  ->  tvey
git  ->  tvg
giu  ->  tvh
giv  ->  tvi
gj  ->  tw
gjat  ->  twng
gje  ->  twr
gjej  ->  twrw
gjo  ->  twb
gk  ->  tx
gka  ->  txn
gl  ->  ty
gla  ->  tyn
glaare  ->  tynner
glana  ->  tynan
glanaf  ->  tynans
glar  ->  tyne
glare  ->  tyner
glat  ->  tyng
glava  ->  tynin
glavat  ->  tyning
glb  ->  tyo
glc  ->  typ
gle  ->  tyr
gleave  ->  tyrnir
gleb  ->  tyro
gleba  ->  tyron
gleby  ->  tyrol
glen  ->  tyra
glena  ->  tyran
gler  ->  tyre
glera  ->  tyren
gles  ->  tyrf
gleva  ->  tyrin
glg  ->  tyt
gli  ->  tyv
glif  ->  tyvs
glin  ->  tyva
glir  ->  tyve
glire  ->  tyver
gln  ->  tya
glo  ->  tyb
glore  ->  tyber
glug  ->  tyht
glx  ->  tyk
gly  ->  tyl
glyb  ->  tylo
glyn  ->  tyla
gm  ->  tz
gmb  ->  tzo
gmf  ->  tzs
gmn  ->  tza
g'n  ->  t'a
gn  ->  ta
gna  ->  tan
gnaa  ->  tann
gnach  ->  tanpu
gnag  ->  tant
gnagna  ->  tantan
gnal  ->  tany
gnam  ->  tanz
gnar  ->  tane
gnara  ->  tanen
gnare  ->  taner
gnarl  ->  taney
gnas  ->  tanf
gnat  ->  tang
gnau  ->  tanh
gnava  ->  tanin
gnaw  ->  tanj
gnawn  ->  tanja
gnb  ->  tao
gnc  ->  tap
gnd  ->  taq
gneg  ->  tart
gnei  ->  tarv
gnet  ->  targ
gnev  ->  tari
gnevan  ->  tarina
gnf  ->  tas
gng  ->  tat
gnh  ->  tau
gni  ->  tav
gnie  ->  tavr
gnil  ->  tavy
gnin  ->  tava
gnir  ->  tave
gniv  ->  tavi
gnl  ->  tay
gnm  ->  taz
gnn  ->  taa
gno  ->  tab
gnof  ->  tabs
gnog  ->  tabt
gnon  ->  taba
gnove  ->  tabir
gnp  ->  tac
gnq  ->  tad
gns  ->  taf
gnss  ->  taff
gnu  ->  tah
gnuen  ->  tahra
gnur  ->  tahe
gnure  ->  taher
gnv  ->  tai
gnvq  ->  taid
go  ->  tb
goa  ->  tbn
goc  ->  tbp
god  ->  tbq
godu  ->  tbqh
goe  ->  tbr
gof  ->  tbs
gog  ->  tbt
goh  ->  tbu
gok  ->  tbx
gon  ->  tba
goog  ->  tbbt
gop  ->  tbc
goq  ->  tbd
gos  ->  tbf
gou  ->  tbh
goud  ->  tbhq
gov  ->  tbi
gox  ->  tbk
goy  ->  tbl
goz  ->  tbm
gozz  ->  tbmm
gp  ->  tc
gpa  ->  tcn
gpc  ->  tcp
gpf  ->  tcs
gpo  ->  tcb
gpr  ->  tce
gps  ->  tcf
gpt  ->  tcg
gpu  ->  tch
gq  ->  td
gr  ->  te
gra  ->  ten
graaf  ->  tenns
graal  ->  tenny
graan  ->  tenna
grab  ->  teno
graba  ->  tenon
grabar  ->  tenone
grabare  ->  tenoner
grabba  ->  tenoon
grabe  ->  tenor
graben  ->  tenora
graber  ->  tenore
grach  ->  tenpu
graf  ->  tens
grafvar  ->  tensine
grag  ->  tent
gragn  ->  tenta
grah  ->  tenu
graha  ->  tenun
grahe  ->  tenur
grahn  ->  tenua
gral  ->  teny
gramr  ->  tenze
gran  ->  tena
granat  ->  tenang
grane  ->  tenar
granean  ->  tenarna
granene  ->  tenarar
granin  ->  tenava
graning  ->  tenavat
grank  ->  tenax
grap  ->  tenc
grat  ->  teng
grath  ->  tengu
grau  ->  tenh
graun  ->  tenha
grav  ->  teni
grava  ->  tenin
gravan  ->  tenina
grave  ->  tenir
grax  ->  tenk
grayn  ->  tenla
grb  ->  teo
grba  ->  teon
grbe  ->  teor
grc  ->  tep
gre  ->  ter
grea  ->  tern
grean  ->  terna
grear  ->  terne
greav  ->  terni
greave  ->  ternir
greb  ->  tero
greba  ->  teron
grebe  ->  teror
grec  ->  terp
gree  ->  terr
greef  ->  terrs
green  ->  terra
greenar  ->  terrane
greene  ->  terrar
greeny  ->  terral
greer  ->  terre
gref  ->  ters
greg  ->  tert
greger  ->  tertre
greh  ->  teru
grei  ->  terv
greil  ->  tervy
grein  ->  terva
greina  ->  tervan
grel  ->  tery
grela  ->  teryn
grem  ->  terz
gren  ->  tera
grena  ->  teran
grenat  ->  terang
grene  ->  terar
grener  ->  terare
greng  ->  terat
greni  ->  terav
grenu  ->  terah
grenz  ->  teram
grep  ->  terc
gres  ->  terf
grev  ->  teri
greva  ->  terin
grez  ->  term
grg  ->  tet
grgt  ->  tetg
grh  ->  teu
gri  ->  tev
gril  ->  tevy
grin  ->  teva
gring  ->  tevat
griv  ->  tevi
grjon  ->  tewba
grk  ->  tex
grl  ->  tey
grle  ->  teyr
grm  ->  tez
grn  ->  tea
grna  ->  tean
gro  ->  teb
grob  ->  tebo
groba  ->  tebon
groby  ->  tebol
groh  ->  tebu
grol  ->  teby
gron  ->  teba
grona  ->  teban
gronk  ->  tebax
gronn  ->  tebaa
grony  ->  tebal
groof  ->  tebbs
gror  ->  tebe
grov  ->  tebi
grp  ->  tec
grr  ->  tee
grrs  ->  teef
grt  ->  teg
gru  ->  teh
grub  ->  teho
gruba  ->  tehon
grun  ->  teha
gruna  ->  tehan
gruvan  ->  tehina
grw  ->  tej
grx  ->  tek
gry  ->  tel
gryf  ->  tels
gryn  ->  tela
gryne  ->  telar
grynna  ->  telaan
gryr  ->  tele
gryre  ->  teler
gryt  ->  telg
gs  ->  tf
gsa  ->  tfn
gsc  ->  tfp
gse  ->  tfr
gsf  ->  tfs
gsg  ->  tft
gso  ->  tfb
gsp  ->  tfc
gsr  ->  tfe
gt  ->  tg
gta  ->  tgn
gtc  ->  tgp
gti  ->  tgv
gtl  ->  tgy
gtn  ->  tga
gtq  ->  tgd
gtr  ->  tge
gts  ->  tgf
gu  ->  th
guat  ->  thng
gub  ->  tho
guba  ->  thon
gubane  ->  thonar
gubat  ->  thong
gube  ->  thor
gubec  ->  thorp
guber  ->  thore
gubna  ->  thoan
gubs  ->  thof
gue  ->  thr
guebara  ->  thronen
guer  ->  thre
guerry  ->  threel
guf  ->  ths
gug  ->  tht
guh  ->  thu
guhar  ->  thune
gui  ->  thv
guk  ->  thx
gul  ->  thy
gula  ->  thyn
gular  ->  thyne
gulat  ->  thyng
gulen  ->  thyra
gulf  ->  thys
gulr  ->  thye
gultu  ->  thygh
gulv  ->  thyi
gum  ->  thz
gun  ->  tha
guna  ->  than
gunch  ->  thapu
gune  ->  thar
guneh  ->  tharu
gung  ->  that
gunk  ->  thax
gunn  ->  thaa
gunner  ->  thaare
gunon  ->  thaba
guo  ->  thb
gup  ->  thc
gur  ->  the
gura  ->  then
guran  ->  thena
gurb  ->  theo
gure  ->  ther
guren  ->  thera
gurl  ->  they
gurle  ->  theyr
gurn  ->  thea
gurr  ->  thee
gurra  ->  theen
gurre  ->  theer
gurrs  ->  theef
gurry  ->  theel
gurt  ->  theg
gus  ->  thf
gut  ->  thg
guv  ->  thi
guw  ->  thj
guz  ->  thm
gv  ->  ti
gva  ->  tin
gval  ->  tiny
gvaq  ->  tind
gvd  ->  tiq
gve  ->  tir
gvera  ->  tiren
gvi  ->  tiv
gvil  ->  tivy
gviv  ->  tivi
gvman  ->  tizna
gvnan  ->  tiana
gvr  ->  tie
gvrs  ->  tief
gvrv  ->  tiei
gvs  ->  tif
gvu  ->  tih
gvw  ->  tij
gw  ->  tj
gwb  ->  tjo
gwg  ->  tjt
gwn  ->  tja
gwrw  ->  tjej
gwx  ->  tjk
gx  ->  tk
gy  ->  tl
gya  ->  tln
gye  ->  tlr
gyi  ->  tlv
gyn  ->  tla
gyo  ->  tlb
gyp  ->  tlc
gyr  ->  tle
gyra  ->  tlen
gyv  ->  tli
gyw  ->  tlj
gyz  ->  tlm
gz  ->  tm
h  ->  u
h'  ->  u'
ha  ->  un
ha'  ->  un'
'ha  ->  'un
haa  ->  unn
haab  ->  unno
haaf  ->  unns
haag  ->  unnt
haan  ->  unna
haane  ->  unnar
haar  ->  unne
haara  ->  unnen
haare  ->  unner
haav  ->  unni
hab  ->  uno
habe  ->  unor
haben  ->  unora
habo  ->  unob
hac  ->  unp
hacher  ->  unpure
had  ->  unq
haen  ->  unra
haf  ->  uns
hafer  ->  unsre
hafn  ->  unsa
hafnar  ->  unsane
hafr  ->  unse
hafrar  ->  unsene
hafre  ->  unser
hafva  ->  unsin
hag  ->  unt
hagl  ->  unty
hagna  ->  untan
hagner  ->  untare
hagr  ->  unte
hagrer  ->  untere
hagrere  ->  unterer
hagung  ->  unthat
hah  ->  unu
haha  ->  unun
hahe  ->  unur
hahen  ->  unura
hahn  ->  unua
hahy  ->  unul
hain  ->  unva
haina  ->  unvan
hajba  ->  unwon
halba  ->  unyon
halv  ->  unyi
ham  ->  unz
hamn  ->  unza
hamna  ->  unzan
hamr  ->  unze
hamra  ->  unzen
han  ->  una
hana  ->  unan
hanbar  ->  unaone
hanel  ->  unary
hanep  ->  unarc
hanf  ->  unas
hang  ->  unat
hany  ->  unal
hao  ->  unb
hap  ->  unc
hapner  ->  uncare
haps  ->  uncf
hapu  ->  unch
haq  ->  und
har  ->  une
hara  ->  unen
haran  ->  unena
harar  ->  unene
harc  ->  unep
harf  ->  unes
harha  ->  uneun
harira  ->  uneven
harpun  ->  unecha
harv  ->  unei
harz  ->  unem
has  ->  unf
hasel  ->  unfry
hat  ->  ung
hate  ->  ungr
haten  ->  ungra
hath  ->  ungu
hathe  ->  ungur
hatna  ->  ungan
hatr  ->  unge
hatra  ->  ungen
hatrea  ->  ungern
hatu  ->  ungh
hatyn  ->  ungla
hatyr  ->  ungle
hau  ->  unh
haub  ->  unho
haun  ->  unha
haung  ->  unhat
haur  ->  unhe
haurja  ->  unhewn
haurne  ->  unhear
hav  ->  uni
hava  ->  unin
havan  ->  unina
havat  ->  uning
have  ->  unir
haven  ->  unira
haver  ->  unire
havere  ->  unirer
havi  ->  univ
havira  ->  univen
havk  ->  unix
havn  ->  unia
havne  ->  uniar
havner  ->  uniare
havr  ->  unie
havra  ->  unien
havren  ->  uniera
havt  ->  unig
havva  ->  uniin
haw  ->  unj
hawn  ->  unja
hax  ->  unk
haxan  ->  unkna
hayi  ->  unlv
hayne  ->  unlar
haze  ->  unmr
hazna  ->  unman
hb  ->  uo
hba  ->  uon
hbc  ->  uop
hbf  ->  uos
hbq  ->  uod
hbt  ->  uog
hby  ->  uol
hc  ->  up
hca  ->  upn
hcf  ->  ups
hci  ->  upv
hcn  ->  upa
hco  ->  upb
hcp  ->  upc
hcr  ->  upe
hcs  ->  upf
hcv  ->  upi
hd  ->  uq
hdv  ->  uqi
he  ->  ur
hea  ->  urn
heaf  ->  urns
hean  ->  urna
hear  ->  urne
heare  ->  urner
heb  ->  uro
heba  ->  uron
hebba  ->  uroon
hebe  ->  uror
hebra  ->  uroen
hec  ->  urp
hech  ->  urpu
hedh  ->  urqu
hee  ->  urr
heeb  ->  urro
heel  ->  urry
heen  ->  urra
heer  ->  urre
heern  ->  urrea
hef  ->  urs
hefna  ->  ursan
heg  ->  urt
hegn  ->  urta
hegna  ->  urtan
hegrar  ->  urtene
hegre  ->  urter
heh  ->  uru
heho  ->  urub
hehr  ->  urue
heht  ->  urug
heiar  ->  urvne
hein  ->  urva
heiny  ->  urval
heir  ->  urve
hel  ->  ury
hemb  ->  urzo
hen  ->  ura
hena  ->  uran
henan  ->  urana
henar  ->  urane
hene  ->  urar
heng  ->  urat
henn  ->  uraa
henna  ->  uraan
hent  ->  urag
henua  ->  urahn
heo  ->  urb
heof  ->  urbs
heon  ->  urba
heonan  ->  urbana
heor  ->  urbe
hep  ->  urc
hepner  ->  urcare
hepu  ->  urch
heq  ->  urd
her  ->  ure
hera  ->  uren
herab  ->  ureno
heran  ->  urena
herar  ->  urene
herb  ->  ureo
here  ->  urer
herear  ->  urerne
herere  ->  urerer
hererer  ->  urerere
herf  ->  ures
herl  ->  urey
herm  ->  urez
hern  ->  urea
herna  ->  urean
heroner  ->  urebare
herr  ->  uree
hersh  ->  urefu
herv  ->  urei
hes  ->  urf
het  ->  urg
heth  ->  urgu
hetu  ->  urgh
hetven  ->  urgira
hev  ->  uri
heva  ->  urin
hevan  ->  urina
hevd  ->  uriq
heven  ->  urira
hevn  ->  uria
hevon  ->  uriba
hewn  ->  urja
hex  ->  urk
hey  ->  url
heyf  ->  urls
heyn  ->  urla
heyne  ->  urlar
heyv  ->  urli
hez  ->  urm
hf  ->  us
hfa  ->  usn
hfc  ->  usp
hfn  ->  usa
hfr  ->  use
hfref  ->  users
hfv  ->  usi
hg  ->  ut
hgb  ->  uto
hgh  ->  utu
hgp  ->  utc
hgs  ->  utf
hgt  ->  utg
hgv  ->  uti
hh  ->  uu
hhe  ->  uur
hhz  ->  uum
hi  ->  uv
hib  ->  uvo
hibe  ->  uvor
hieb  ->  uvro
hier  ->  uvre
hieve  ->  uvrir
hif  ->  uvs
hiir  ->  uvve
hin  ->  uva
hina  ->  uvan
hine  ->  uvar
hinef  ->  uvars
hinz  ->  uvam
hir  ->  uve
hira  ->  uven
hire  ->  uver
hiren  ->  uvera
hirn  ->  uvea
hirr  ->  uvee
his  ->  uvf
hiv  ->  uvi
hj  ->  uw
hjb  ->  uwo
hjo  ->  uwb
hk  ->  ux
hl  ->  uy
hlav  ->  uyni
hlbt  ->  uyog
hm  ->  uz
hmf  ->  uzs
hmh  ->  uzu
hmla  ->  uzyn
hmo  ->  uzb
hmu  ->  uzh
hmv  ->  uzi
hn  ->  ua
hna  ->  uan
hnat  ->  uang
hnc  ->  uap
hnd  ->  uaq
hne  ->  uar
hng  ->  uat
hni  ->  uav
hno  ->  uab
hnp  ->  uac
hnu  ->  uah
hnuv  ->  uahi
hny  ->  ual
ho  ->  ub
hoa  ->  ubn
hob  ->  ubo
hoben  ->  ubora
hobt  ->  ubog
hoc  ->  ubp
hod  ->  ubq
hoer  ->  ubre
hoeve  ->  ubrir
hof  ->  ubs
hog  ->  ubt
hoh  ->  ubu
hohe  ->  ubur
holk  ->  ubyx
hon  ->  uba
hona  ->  uban
hone  ->  ubar
honen  ->  ubara
honer  ->  ubare
hong  ->  ubat
honk  ->  ubax
hont  ->  ubag
honu  ->  ubah
hony  ->  ubal
hoo  ->  ubb
hoon  ->  ubba
hop  ->  ubc
hopf  ->  ubcs
hor  ->  ube
hore  ->  uber
horen  ->  ubera
horer  ->  ubere
horere  ->  uberer
horerer  ->  uberere
horu  ->  ubeh
hou  ->  ubh
houn  ->  ubha
hov  ->  ubi
hovy  ->  ubil
hp  ->  uc
hpc  ->  ucp
hpf  ->  ucs
hph  ->  ucu
hpr  ->  uce
hpv  ->  uci
hpy  ->  ucl
hq  ->  ud
hqc  ->  udp
hql  ->  udy
hqp  ->  udc
hqs  ->  udf
hr  ->  ue
hrab  ->  ueno
hre  ->  uer
hreb  ->  uero
hren  ->  uera
hru  ->  ueh
hrv  ->  uei
hry  ->  uel
hs  ->  uf
hsf  ->  ufs
hsh  ->  ufu
hsl  ->  ufy
hsn  ->  ufa
hsp  ->  ufc
hss  ->  uff
hsv  ->  ufi
ht  ->  ug
htf  ->  ugs
htg  ->  ugt
hth  ->  ugu
htp  ->  ugc
htr  ->  uge
htu  ->  ugh
hu  ->  uh
hub  ->  uho
huba  ->  uhon
hube  ->  uhor
huby  ->  uhol
huc  ->  uhp
hue  ->  uhr
huel  ->  uhry
huer  ->  uhre
huera  ->  uhren
hueva  ->  uhrin
huf  ->  uhs
hug  ->  uht
huh  ->  uhu
huhu  ->  uhuh
hui  ->  uhv
huj  ->  uhw
hulen  ->  uhyra
huler  ->  uhyre
hum  ->  uhz
hun  ->  uha
huna  ->  uhan
huneg  ->  uhart
hung  ->  uhat
hup  ->  uhc
huq  ->  uhd
hur  ->  uhe
hure  ->  uher
hury  ->  uhel
hus  ->  uhf
huu  ->  uhh
huv  ->  uhi
huva  ->  uhin
huy  ->  uhl
huyre  ->  uhler
huz  ->  uhm
hv  ->  ui
hva  ->  uin
hvar  ->  uine
hvatr  ->  uinge
hvin  ->  uiva
hvo  ->  uib
hw  ->  uj
hwan  ->  ujna
hwb  ->  ujo
hwn  ->  uja
hx  ->  uk
hxc  ->  ukp
hy  ->  ul
hya  ->  uln
hyane  ->  ulnar
hyar  ->  ulne
hyc  ->  ulp
hyf  ->  uls
hygh  ->  ultu
hygher  ->  ulture
hygra  ->  ulten
hyh  ->  ulu
hyi  ->  ulv
hyn  ->  ula
hynaf  ->  ulans
hyne  ->  ular
hyns  ->  ulaf
hynt  ->  ulag
hyp  ->  ulc
hyr  ->  ule
hyra  ->  ulen
hyre  ->  uler
hyrr  ->  ulee
hyrt  ->  uleg
hys  ->  ulf
hyse  ->  ulfr
hyt  ->  ulg
hyv  ->  uli
hyva  ->  ulin
hyver  ->  ulire
hyvin  ->  uliva
hyw  ->  ulj
hyy  ->  ull
hyyry  ->  ullel
hyz  ->  ulm
hz  ->  um
hzrg  ->  umet
i  ->  v
i'  ->  v'
ia  ->  vn
iaaf  ->  vnns
iaf  ->  vns
iane  ->  vnar
iap  ->  vnc
iapu  ->  vnch
iaq  ->  vnd
iar  ->  vne
iaz  ->  vnm
ib  ->  vo
iba  ->  von
ibag  ->  vont
ibam  ->  vonz
iban  ->  vona
ibar  ->  vone
ibare  ->  voner
ibat  ->  vong
ibb  ->  voo
ibc  ->  vop
ibe  ->  vor
ibel  ->  vory
iben  ->  vora
iber  ->  vore
ibera  ->  voren
iberar  ->  vorene
ibere  ->  vorer
iberen  ->  vorera
iberer  ->  vorere
ibex  ->  vork
ibf  ->  vos
ibh  ->  vou
ibi  ->  vov
ibira  ->  voven
ibm  ->  voz
ibman  ->  vozna
ibmr  ->  voze
ibn  ->  voa
ibna  ->  voan
ibne  ->  voar
ibnon  ->  voaba
ibo  ->  vob
ibr  ->  voe
ibs  ->  vof
ibta  ->  vogn
ibu  ->  voh
ic  ->  vp
ica  ->  vpn
icf  ->  vps
icn  ->  vpa
icp  ->  vpc
icq  ->  vpd
ict  ->  vpg
icy  ->  vpl
ie  ->  vr
ieb  ->  vro
iec  ->  vrp
ief  ->  vrs
ieg  ->  vrt
iel  ->  vry
iels  ->  vryf
ien  ->  vra
iena  ->  vran
iens  ->  vraf
ieo  ->  vrb
ier  ->  vre
iere  ->  vrer
iert  ->  vreg
iet  ->  vrg
ieu  ->  vrh
iev  ->  vri
ieva  ->  vrin
if  ->  vs
ifc  ->  vsp
iff  ->  vss
ifi  ->  vsv
ifo  ->  vsb
ifr  ->  vse
ifs  ->  vsf
ifv  ->  vsi
ig  ->  vt
ige  ->  vtr
igf  ->  vts
igg  ->  vtt
ign  ->  vta
igu  ->  vth
ih  ->  vu
iha  ->  vun
ihan  ->  vuna
ihat  ->  vung
ihb  ->  vuo
ihe  ->  vur
ihera  ->  vuren
ihi  ->  vuv
ihm  ->  vuz
ihn  ->  vua
ihr  ->  vue
ihrer  ->  vuere
ihs  ->  vuf
iht  ->  vug
ihu  ->  vuh
ihv  ->  vui
ii  ->  vv
iih  ->  vvu
iin  ->  vva
iix  ->  vvk
ij  ->  vw
ijn  ->  vwa
ijs  ->  vwf
ik  ->  vx
ikra  ->  vxen
ikre  ->  vxer
il  ->  vy
ila  ->  vyn
ilal  ->  vyny
ilar  ->  vyne
ilare  ->  vyner
iler  ->  vyre
ili  ->  vyv
ilr  ->  vye
ils  ->  vyf
ilta  ->  vygn
im  ->  vz
imbe  ->  vzor
imi  ->  vzv
imni  ->  vzav
in  ->  va
ina  ->  van
inagu  ->  vanth
inah  ->  vanu
inaha  ->  vanun
inahin  ->  vanuva
inal  ->  vany
inan  ->  vana
inana  ->  vanan
inane  ->  vanar
inaner  ->  vanare
inang  ->  vanat
inap  ->  vanc
inar  ->  vane
inara  ->  vanen
inat  ->  vang
inate  ->  vangr
inau  ->  vanh
inauna  ->  vanhan
inav  ->  vani
inay  ->  vanl
inc  ->  vap
incan  ->  vapna
incha  ->  vapun
inche  ->  vapur
inchyn  ->  vapula
ind  ->  vaq
ine  ->  var
inear  ->  varne
ineare  ->  varner
ineb  ->  varo
inee  ->  varr
ineen  ->  varra
inei  ->  varv
inel  ->  vary
inen  ->  vara
inene  ->  varar
ineng  ->  varat
ineny  ->  varal
ineo  ->  varb
ineor  ->  varbe
iner  ->  vare
inere  ->  varer
inet  ->  varg
inex  ->  vark
inez  ->  varm
inf  ->  vas
infra  ->  vasen
infre  ->  vaser
ing  ->  vat
inga  ->  vatn
ingaf  ->  vatns
ingan  ->  vatna
ingang  ->  vatnat
ingar  ->  vatne
ingen  ->  vatra
ingera  ->  vatren
ingne  ->  vatar
ingu  ->  vath
inh  ->  vau
inhg  ->  vaut
ini  ->  vav
iniba  ->  vavon
inii  ->  vavv
inin  ->  vava
ining  ->  vavat
inj  ->  vaw
inje  ->  vawr
ink  ->  vax
inm  ->  vaz
inmon  ->  vazba
inn  ->  vaa
inna  ->  vaan
innar  ->  vaane
inne  ->  vaar
innen  ->  vaara
inny  ->  vaal
ino  ->  vab
inon  ->  vaba
inoru  ->  vabeh
inpure  ->  vacher
inr  ->  vae
ins  ->  vaf
inser  ->  vafre
inss  ->  vaff
int  ->  vag
inta  ->  vagn
intan  ->  vagna
intha  ->  vagun
intl  ->  vagy
intr  ->  vage
intra  ->  vagen
intre  ->  vager
intrer  ->  vagere
intrere  ->  vagerer
intua  ->  vaghn
inty  ->  vagl
inu  ->  vah
inua  ->  vahn
inug  ->  vaht
inui  ->  vahv
inunan  ->  vahana
inung  ->  vahat
inunn  ->  vahaa
inure  ->  vaher
inv  ->  vai
inva  ->  vain
invar  ->  vaine
inver  ->  vaire
inxa  ->  vakn
iny  ->  val
io  ->  vb
ioe  ->  vbr
iof  ->  vbs
ioi  ->  vbv
ion  ->  vba
ioon  ->  vbba
ip  ->  vc
ipc  ->  vcp
ipe  ->  vcr
ipf  ->  vcs
ipo  ->  vcb
ipof  ->  vcbs
ipp  ->  vcc
ipy  ->  vcl
iq  ->  vd
ir  ->  ve
ira  ->  ven
iraan  ->  venna
iraba  ->  venon
iram  ->  venz
iran  ->  vena
iranar  ->  venane
irane  ->  venar
iraner  ->  venare
iranere  ->  venarer
irap  ->  venc
iraq  ->  vend
irar  ->  vene
irara  ->  venen
irat  ->  veng
iraun  ->  venha
irava  ->  venin
irb  ->  veo
irc  ->  vep
ircer  ->  vepre
ire  ->  ver
ireba  ->  veron
iree  ->  verr
irei  ->  verv
irem  ->  verz
iren  ->  vera
irena  ->  veran
irene  ->  verar
ireng  ->  verat
irer  ->  vere
irere  ->  verer
ires  ->  verf
iret  ->  verg
iretur  ->  verghe
irez  ->  verm
irf  ->  ves
irfan  ->  vesna
irg  ->  vet
irgl  ->  vety
irgu  ->  veth
iri  ->  vev
irin  ->  veva
irine  ->  vevar
iring  ->  vevat
iriq  ->  vevd
irir  ->  veve
irk  ->  vex
irl  ->  vey
irm  ->  vez
irn  ->  vea
irne  ->  vear
irp  ->  vec
irpf  ->  vecs
irq  ->  ved
irql  ->  vedy
irr  ->  vee
irra  ->  veen
irre  ->  veer
irren  ->  veera
irrer  ->  veere
irrt  ->  veeg
irs  ->  vef
irse  ->  vefr
irt  ->  veg
irta  ->  vegn
irte  ->  vegr
irten  ->  vegra
irthe  ->  vegur
irts  ->  vegf
irung  ->  vehat
irur  ->  vehe
irv  ->  vei
irve  ->  veir
irven  ->  veira
irvi  ->  veiv
irvin  ->  veiva
iry  ->  vel
is  ->  vf
ise  ->  vfr
isef  ->  vfrs
isf  ->  vfs
isk  ->  vfx
iso  ->  vfb
isy  ->  vfl
isz  ->  vfm
it  ->  vg
ita  ->  vgn
itf  ->  vgs
itn  ->  vga
ito  ->  vgb
itp  ->  vgc
itv  ->  vgi
iu  ->  vh
iuc  ->  vhp
iuo  ->  vhb
ius  ->  vhf
iv  ->  vi
iva  ->  vin
ivaa  ->  vinn
ivaan  ->  vinna
ivaavat  ->  vinning
ivan  ->  vina
ivana  ->  vinan
ivar  ->  vine
ivas  ->  vinf
ivat  ->  ving
ivb  ->  vio
ivc  ->  vip
ive  ->  vir
ivel  ->  viry
iver  ->  vire
iveren  ->  virera
ivey  ->  virl
ivf  ->  vis
ivg  ->  vit
ivgun  ->  vitha
ivi  ->  viv
ivier  ->  vivre
ivil  ->  vivy
ivin  ->  viva
ivm  ->  viz
ivo  ->  vib
ivor  ->  vibe
ivr  ->  vie
ivre  ->  vier
ivrea  ->  viern
ivrs  ->  vief
ivry  ->  viel
ivs  ->  vif
ivt  ->  vig
ivth  ->  vigu
ivu  ->  vih
ivuz  ->  vihm
ivy  ->  vil
iw  ->  vj
iwf  ->  vjs
ix  ->  vk
ixu  ->  vkh
ixv  ->  vki
iy  ->  vl
iyan  ->  vlna
iyng  ->  vlat
iynx  ->  vlak
iyu  ->  vlh
iyun  ->  vlha
iz  ->  vm
ize  ->  vmr
izq  ->  vmd
izr  ->  vme
izz  ->  vmm
j  ->  w
ja  ->  wn
ja'  ->  wn'
jaa  ->  wnn
jaag  ->  wnnt
jaar  ->  wnne
jaf  ->  wns
jag  ->  wnt
jah  ->  wnu
jaj  ->  wnw
jaja  ->  wnwn
jan  ->  wna
jao  ->  wnb
jaon  ->  wnba
jap  ->  wnc
jaq  ->  wnd
jarg  ->  wnet
jarv  ->  wnei
jat  ->  wng
jaw  ->  wnj
jay  ->  wnl
jaz  ->  wnm
jazw  ->  wnmj
jb  ->  wo
jbd  ->  woq
jbj  ->  wow
jbn  ->  woa
jbo  ->  wob
jbr  ->  woe
jbt  ->  wog
jby  ->  wol
jc  ->  wp
jcp  ->  wpc
jct  ->  wpg
je  ->  wr
jeba  ->  wron
jebat  ->  wrong
jec  ->  wrp
jee  ->  wrr
jef  ->  wrs
jeg  ->  wrt
jeh  ->  wru
jel  ->  wry
jen  ->  wra
jenan  ->  wrana
jenat  ->  wrang
jeng  ->  wrat
jenm  ->  wraz
jenns  ->  wraaf
jens  ->  wraf
jep  ->  wrc
jer  ->  wre
jera  ->  wren
jerba  ->  wreon
jeu  ->  wrh
jf  ->  ws
jfr  ->  wse
jg  ->  wt
jgn  ->  wta
jgs  ->  wtf
jh  ->  wu
jha  ->  wun
jhem  ->  wurz
jhm  ->  wuz
jho  ->  wub
jhon  ->  wuba
jhuna  ->  wuhan
jhy  ->  wul
ji  ->  wv
jib  ->  wvo
jie  ->  wvr
jih  ->  wvu
jiu  ->  wvh
jj  ->  ww
jjj  ->  www
jk  ->  wx
jl  ->  wy
jla  ->  wyn
jlb  ->  wyo
jms  ->  wzf
jn  ->  wa
jna  ->  wan
jnana  ->  wanan
jnb  ->  wao
jne  ->  war
jng  ->  wat
jnj  ->  waw
jnk  ->  wax
jnm  ->  waz
jnn  ->  waa
jno  ->  wab
jnov  ->  wabi
jnq  ->  wad
jnr  ->  wae
jns  ->  waf
jnt  ->  wag
jntf  ->  wags
jnu  ->  wah
jnw  ->  waj
jo  ->  wb
joa  ->  wbn
job  ->  wbo
joh  ->  wbu
joj  ->  wbw
jon  ->  wba
joq  ->  wbd
jor  ->  wbe
jos  ->  wbf
jp  ->  wc
jpf  ->  wcs
jpn  ->  wca
jps  ->  wcf
jpt  ->  wcg
jr  ->  we
jra  ->  wen
jrav  ->  weni
jre  ->  wer
jref  ->  wers
jres  ->  werf
jrg  ->  wet
jrp  ->  wec
jrt  ->  weg
jrw  ->  wej
jry  ->  wel
js  ->  wf
jsc  ->  wfp
jsp  ->  wfc
jsu  ->  wfh
jsw  ->  wfj
jsx  ->  wfk
jsy  ->  wfl
jt  ->  wg
jtn  ->  wga
juba  ->  whon
jubar  ->  whone
jubb  ->  whoo
jubber  ->  whoore
jud  ->  whq
jue  ->  whr
juf  ->  whs
jug  ->  wht
juhe  ->  whur
jul  ->  why
jula  ->  whyn
jular  ->  whyne
jun  ->  wha
juna  ->  whan
junan  ->  whana
junat  ->  whang
junc  ->  whap
june  ->  whar
juner  ->  whare
junes  ->  wharf
jung  ->  what
jungh  ->  whatu
jungu  ->  whath
junh  ->  whau
juny  ->  whal
jur  ->  whe
jura  ->  when
jure  ->  wher
jurer  ->  where
jures  ->  wherf
jurny  ->  wheal
jurry  ->  wheel
jury  ->  whel
juva  ->  whin
juvara  ->  whinen
juvare  ->  whiner
juvat  ->  whing
juve  ->  whir
juvey  ->  whirl
juvy  ->  whil
juz  ->  whm
jv  ->  wi
jva  ->  win
jvb  ->  wio
jvc  ->  wip
jvm  ->  wiz
jvp  ->  wic
jvs  ->  wif
jw  ->  wj
jx  ->  wk
jy  ->  wl
jyn  ->  wla
jynx  ->  wlak
jz  ->  wm
k  ->  x
ka  ->  xn
kabe  ->  xnor
kah  ->  xnu
kan  ->  xna
kanaq  ->  xnand
kb  ->  xo
kba  ->  xon
kbar  ->  xone
kbbq  ->  xood
kbc  ->  xop
kbe  ->  xor
kbh  ->  xou
kbir  ->  xove
kbira  ->  xoven
kbm  ->  xoz
kbn  ->  xoa
kbp  ->  xoc
kbq  ->  xod
kbr  ->  xoe
kbs  ->  xof
kc  ->  xp
kcb  ->  xpo
kcn  ->  xpa
kcs  ->  xpf
kd  ->  xq
kdf  ->  xqs
ke  ->  xr
kec  ->  xrp
kee  ->  xrr
kenen  ->  xrara
kens  ->  xraf
keq  ->  xrd
kes  ->  xrf
kf  ->  xs
kg  ->  xt
kgf  ->  xts
kgz  ->  xtm
kh  ->  xu
kha  ->  xun
khaf  ->  xuns
khat  ->  xung
khe  ->  xur
kheh  ->  xuru
khen  ->  xura
khene  ->  xurar
kher  ->  xure
khi  ->  xuv
khne  ->  xuar
khon  ->  xuba
khona  ->  xuban
khr  ->  xue
khs  ->  xuf
ki  ->  xv
kian  ->  xvna
kiv  ->  xvi
kj  ->  xw
kk  ->  xx
kkb  ->  xxo
kkk  ->  xxx
kkv  ->  xxi
kl  ->  xy
kle  ->  xyr
klef  ->  xyrs
klm  ->  xyz
kln  ->  xya
kly  ->  xyl
klyf  ->  xyls
kn  ->  xa
kna  ->  xan
knab  ->  xano
knaf  ->  xans
knager  ->  xantre
knan  ->  xana
knani  ->  xanav
knc  ->  xap
kne  ->  xar
kng  ->  xat
kni  ->  xav
knien  ->  xavra
knin  ->  xava
knir  ->  xave
kniv  ->  xavi
knk  ->  xax
kno  ->  xab
knob  ->  xabo
knoer  ->  xabre
kns  ->  xaf
kny  ->  xal
knyf  ->  xals
knyn  ->  xala
knyv  ->  xali
kobar  ->  xbone
kog  ->  xbt
kok  ->  xbx
kon  ->  xba
kona  ->  xban
koo  ->  xbb
kop  ->  xbc
koy  ->  xbl
koyn  ->  xbla
kp  ->  xc
kpi  ->  xcv
kr  ->  xe
kra  ->  xen
krab  ->  xeno
kraba  ->  xenon
krah  ->  xenu
kraly  ->  xenyl
kran  ->  xena
krar  ->  xene
krav  ->  xeni
krb  ->  xeo
kre  ->  xer
kren  ->  xera
krene  ->  xerar
krenon  ->  xeraba
krev  ->  xeri
krf  ->  xes
kriv  ->  xevi
krk  ->  xex
krong  ->  xebat
kronu  ->  xebah
kroo  ->  xebb
kroon  ->  xebba
kroonu  ->  xebbah
krou  ->  xebh
krp  ->  xec
krs  ->  xef
kru  ->  xeh
kry  ->  xel
kryb  ->  xelo
kryna  ->  xelan
ks  ->  xf
ksh  ->  xfu
kss  ->  xff
ku  ->  xh
kue  ->  xhr
kuna  ->  xhan
kunz  ->  xham
kupa  ->  xhcn
kur  ->  xhe
kurc  ->  xhep
kury  ->  xhel
kv  ->  xi
kva  ->  xin
kvan  ->  xina
kvar  ->  xine
kvat  ->  xing
kvau  ->  xinh
kve  ->  xir
kven  ->  xira
kvenen  ->  xirara
kverv  ->  xirei
kvf  ->  xis
kvi  ->  xiv
kvin  ->  xiva
kvk  ->  xix
kvm  ->  xiz
kwb  ->  xjo
kx  ->  xk
ky  ->  xl
kyi  ->  xlv
kyiv  ->  xlvi
kyn  ->  xla
kz  ->  xm
kzn  ->  xma
l  ->  y
l'  ->  y'
'l  ->  'y
la  ->  yn
laa  ->  ynn
laar  ->  ynne
lab  ->  yno
labar  ->  ynone
labu  ->  ynoh
lagn  ->  ynta
lan  ->  yna
lanyu  ->  ynalh
lapu  ->  ynch
lapur  ->  ynche
lar  ->  yne
larm  ->  ynez
lat  ->  yng
laten  ->  yngra
later  ->  yngre
latg  ->  yngt
latin  ->  yngva
latine  ->  yngvar
latir  ->  yngve
lativ  ->  yngvi
latn  ->  ynga
latr  ->  ynge
latyn  ->  yngla
lav  ->  yni
lax  ->  ynk
lb  ->  yo
lba  ->  yon
lbb  ->  yoo
lbd  ->  yoq
lbf  ->  yos
lbj  ->  yow
lbk  ->  yox
lbl  ->  yoy
lbm  ->  yoz
lbn  ->  yoa
lbo  ->  yob
lbr  ->  yoe
lbs  ->  yof
lbv  ->  yoi
lby  ->  yol
lc  ->  yp
lcc  ->  ypp
lccn  ->  yppa
lcf  ->  yps
lct  ->  ypg
le  ->  yr
lea  ->  yrn
leana  ->  yrnan
leer  ->  yrre
lef  ->  yrs
leg  ->  yrt
len  ->  yra
lener  ->  yrare
lenx  ->  yrak
leq  ->  yrd
ler  ->  yre
lex  ->  yrk
lf  ->  ys
lfb  ->  yso
lfg  ->  yst
lfns  ->  ysaf
lft  ->  ysg
lfv  ->  ysi
lg  ->  yt
lgc  ->  ytp
lgh  ->  ytu
lgn  ->  yta
lgv  ->  yti
lh  ->  yu
lha  ->  yun
lhaba  ->  yunon
lhc  ->  yup
lhe  ->  yur
lhend  ->  yuraq
lher  ->  yure
lhf  ->  yus
lhp  ->  yuc
lhr  ->  yue
lhs  ->  yuf
lhx  ->  yuk
li  ->  yv
lib  ->  yvo
liba  ->  yvon
libe  ->  yvor
libel  ->  yvory
liber  ->  yvore
lier  ->  yvre
lilen  ->  yvyra
lily  ->  yvyl
lim  ->  yvz
lin  ->  yva
lina  ->  yvan
lire  ->  yver
liry  ->  yvel
lisia  ->  yvfvn
liv  ->  yvi
live  ->  yvir
livt  ->  yvig
lj  ->  yw
ljo  ->  ywb
ljun  ->  ywha
lkna  ->  yxan
ll  ->  yy
llg  ->  yyt
lln  ->  yya
ln  ->  ya
lna  ->  yan
lnav  ->  yani
lnb  ->  yao
lnc  ->  yap
lne  ->  yar
lner  ->  yare
lng  ->  yat
lnh  ->  yau
lnp  ->  yac
lns  ->  yaf
lnt  ->  yag
lnu  ->  yah
lnwr  ->  yaje
lny  ->  yal
lo  ->  yb
lober  ->  ybore
loc  ->  ybp
lod  ->  ybq
lohena  ->  yburan
lon  ->  yba
lor  ->  ybe
lorra  ->  ybeen
lp  ->  yc
lpr  ->  yce
lq  ->  yd
lr  ->  ye
lra  ->  yen
lrc  ->  yep
lrg  ->  yet
lrn  ->  yea
lrna  ->  yean
lrne  ->  year
lro  ->  yeb
lrt  ->  yeg
ls  ->  yf
lt  ->  yg
ltl  ->  ygy
lu  ->  yh
luh  ->  yhu
luju  ->  yhwh
lull  ->  yhyy
lum  ->  yhz
lun  ->  yha
luog  ->  yhbt
lur  ->  yhe
luv  ->  yhi
luz  ->  yhm
lv  ->  yi
lva  ->  yin
lve  ->  yir
lvh  ->  yiu
lvs  ->  yif
lvt  ->  yig
lw  ->  yj
lwr  ->  yje
lx  ->  yk
lxx  ->  ykk
ly  ->  yl
lyc  ->  ylp
lye  ->  ylr
lyf  ->  yls
lyhe  ->  ylur
lyj  ->  ylw
lyk  ->  ylx
lyn  ->  yla
lyne  ->  ylar
lyng  ->  ylat
lyr  ->  yle
lyra  ->  ylen
lyte  ->  ylgr
lyv  ->  yli
lz  ->  ym
lzo  ->  ymb
m  ->  z
m'  ->  z'
'm  ->  'z
m'a  ->  z'n
ma  ->  zn
mab  ->  zno
mag  ->  znt
man  ->  zna
mana  ->  znan
manal  ->  znany
manan  ->  znana
manar  ->  znane
manav  ->  znani
mang  ->  znat
mangl  ->  znaty
manx  ->  znak
many  ->  znal
manz  ->  znam
mao  ->  znb
mar  ->  zne
marw  ->  znej
mas  ->  znf
mav  ->  zni
maw  ->  znj
mb  ->  zo
mba  ->  zon
mbaar  ->  zonne
mbaara  ->  zonnen
mban  ->  zona
mbaq  ->  zond
mbar  ->  zone
mbat  ->  zong
mbbs  ->  zoof
mbc  ->  zop
mbcs  ->  zopf
mbd  ->  zoq
mbe  ->  zor
mbean  ->  zorna
mbeh  ->  zoru
mbet  ->  zorg
mbh  ->  zou
mbi  ->  zov
mbin  ->  zova
mbl  ->  zoy
mbm  ->  zoz
mbo  ->  zob
mbong  ->  zobat
mbr  ->  zoe
mbt  ->  zog
mbu  ->  zoh
mbul  ->  zohy
mbva  ->  zoin
mbwn  ->  zoja
mby  ->  zol
mc  ->  zp
mcf  ->  zps
mcg  ->  zpt
mct  ->  zpg
me  ->  zr
mea  ->  zrn
mean  ->  zrna
meang  ->  zrnat
melj  ->  zryw
men  ->  zra
mer  ->  zre
merr  ->  zree
mery  ->  zrel
mf  ->  zs
mfh  ->  zsu
mfi  ->  zsv
mg  ->  zt
mh  ->  zu
mha  ->  zun
mhaa  ->  zunn
mhc  ->  zup
mhcs  ->  zupf
mhen  ->  zura
mhg  ->  zut
mhh  ->  zuu
mhj  ->  zuw
mhm  ->  zuz
mhn  ->  zua
mho  ->  zub
mhol  ->  zuby
mhp  ->  zuc
mhw  ->  zuj
mhz  ->  zum
mi  ->  zv
minen  ->  zvara
mire  ->  zver
mirex  ->  zverk
mith  ->  zvgu
mj  ->  zw
mja  ->  zwn
mje  ->  zwr
mjn  ->  zwa
mjo  ->  zwb
mjr  ->  zwe
mjw  ->  zwj
ml  ->  zy
mla  ->  zyn
mlin  ->  zyva
mlk  ->  zyx
mlon  ->  zyba
mlp  ->  zyc
mlu  ->  zyh
mlyn  ->  zyla
mm  ->  zz
mmb  ->  zzo
mmm  ->  zzz
mmmm  ->  zzzz
mmmmmm  ->  zzzzzz
mmn  ->  zza
mn  ->  za
mna  ->  zan
mnc  ->  zap
mncs  ->  zapf
mnd  ->  zaq
mne  ->  zar
mnene  ->  zarar
mner  ->  zare
mng  ->  zat
mnh  ->  zau
mnhz  ->  zaum
mni  ->  zav
mnj  ->  zaw
mnmn  ->  zaza
mno  ->  zab
mnp  ->  zac
mns  ->  zaf
mnt  ->  zag
mnu  ->  zah
mnw  ->  zaj
mo  ->  zb
moa  ->  zbn
mobe  ->  zbor
mod  ->  zbq
mone  ->  zbar
mong  ->  zbat
mongu  ->  zbath
morn  ->  zbea
moru  ->  zbeh
morw  ->  zbej
move  ->  zbir
movo  ->  zbib
mow  ->  zbj
mp  ->  zc
mpa  ->  zcn
mq  ->  zd
mqr  ->  zde
mqs  ->  zdf
mr  ->  ze
mra  ->  zen
mraba  ->  zenon
mram  ->  zenz
mran  ->  zena
mrav  ->  zeni
mrb  ->  zeo
mrc  ->  zep
mrcc  ->  zepp
mre  ->  zer
mrenin  ->  zerava
mres  ->  zerf
mrf  ->  zes
mri  ->  zev
mrj  ->  zew
mrl  ->  zey
mrm  ->  zez
mrna  ->  zean
mro  ->  zeb
mron  ->  zeba
mrp  ->  zec
mrrt  ->  zeeg
mrs  ->  zef
mrt  ->  zeg
mru  ->  zeh
mrv  ->  zei
mrva  ->  zein
mrwr  ->  zeje
mry  ->  zel
mrz  ->  zem
ms  ->  zf
msa  ->  zfn
msg  ->  zft
msp  ->  zfc
mt  ->  zg
mtl  ->  zgy
mtrt  ->  zgeg
mu  ->  zh
muat  ->  zhng
mue  ->  zhr
muh  ->  zhu
muha  ->  zhun
muhi  ->  zhuv
muhn  ->  zhua
muht  ->  zhug
mulg  ->  zhyt
mum  ->  zhz
mun  ->  zha
muna  ->  zhan
munat  ->  zhang
munch  ->  zhapu
munen  ->  zhara
munu  ->  zhah
mur  ->  zhe
mura  ->  zhen
murat  ->  zheng
murr  ->  zhee
murt  ->  zheg
muru  ->  zheh
muva  ->  zhin
mv  ->  zi
mva  ->  zin
mvb  ->  zio
mvc  ->  zip
mvcc  ->  zipp
mvcs  ->  zipf
mvfr  ->  zise
mvg  ->  zit
mvh  ->  ziu
mvi  ->  ziv
mvp  ->  zic
mvpv  ->  zici
mvr  ->  zie
mvs  ->  zif
mvt  ->  zig
mw  ->  zj
mwa  ->  zjn
mwr  ->  zje
mx  ->  zk
my  ->  zl
mye  ->  zlr
myh  ->  zlu
myk  ->  zlx
myl  ->  zly
myn  ->  zla
myntan  ->  zlagna
myr  ->  zle
myy  ->  zll
mz  ->  zm
mzn  ->  zma
n  ->  a
n'  ->  a'
'n  ->  'a
'n'  ->  'a'
na  ->  an
na'  ->  an'
naa  ->  ann
naab  ->  anno
naaf  ->  anns
naag  ->  annt
naan  ->  anna
naana  ->  annan
naang  ->  annat
naar  ->  anne
naara  ->  annen
naava  ->  annin
naavan  ->  annina
naavat  ->  anning
nab  ->  ano
naba  ->  anon
nabaa  ->  anonn
naban  ->  anona
nabar  ->  anone
nabat  ->  anong
nabb  ->  anoo
nabbe  ->  anoor
nabe  ->  anor
nabl  ->  anoy
nabq  ->  anod
naby  ->  anol
nac  ->  anp
nace  ->  anpr
naf  ->  ans
naff  ->  anss
nafn  ->  ansa
nafna  ->  ansan
nafren  ->  ansera
nafrer  ->  ansere
nag  ->  ant
nagen  ->  antra
nagent  ->  antrag
nager  ->  antre
nagh  ->  antu
nagi  ->  antv
nagl  ->  anty
nagr  ->  ante
nagra  ->  anten
nagraa  ->  antenn
nagrany  ->  antenal
nah  ->  anu
nahan  ->  anuna
nahe  ->  anur
nahen  ->  anura
naht  ->  anug
nahu  ->  anuh
nai  ->  anv
naia  ->  anvn
naie  ->  anvr
naina  ->  anvan
naiv  ->  anvi
nak  ->  anx
nal  ->  any
nam  ->  anz
namh  ->  anzu
namn  ->  anza
namna  ->  anzan
namra  ->  anzen
nan  ->  ana
nana  ->  anan
nanaa  ->  anann
nanan  ->  anana
nanaq  ->  anand
nanar  ->  anane
nanc  ->  anap
nane  ->  anar
nang  ->  anat
nangv  ->  anati
nani  ->  anav
nanin  ->  anava
nann  ->  anaa
nannan  ->  anaana
nanny  ->  anaal
nans  ->  anaf
nant  ->  anag
nanu  ->  anah
naon  ->  anba
nap  ->  anc
napba  ->  ancon
napban  ->  ancona
naper  ->  ancre
napf  ->  ancs
napp  ->  ancc
napu  ->  anch
napur  ->  anche
napura  ->  anchen
napyn  ->  ancla
naq  ->  and
naqba  ->  andon
naqra  ->  anden
naqv  ->  andi
nar  ->  ane
nara  ->  anen
narag  ->  anent
naran  ->  anena
narat  ->  aneng
nare  ->  aner
narf  ->  anes
narg  ->  anet
nark  ->  anex
naro  ->  aneb
narran  ->  aneena
naru  ->  aneh
nary  ->  anel
nas  ->  anf
nasba  ->  anfon
nat  ->  ang
nate  ->  angr
natel  ->  angry
nater  ->  angre
natera  ->  angren
natere  ->  angrer
nath  ->  angu
nathe  ->  angur
nather  ->  angure
natl  ->  angy
natnat  ->  angang
natrag  ->  angent
natury  ->  anghel
naty  ->  angl
nau  ->  anh
nav  ->  ani
nava  ->  anin
navan  ->  anina
navat  ->  aning
navbar  ->  anione
navn  ->  ania
navna  ->  anian
navne  ->  aniar
navo  ->  anib
navon  ->  aniba
navra  ->  anien
navs  ->  anif
navy  ->  anil
naw  ->  anj
nawbin  ->  anjova
nawn  ->  anja
naxer  ->  ankre
naz  ->  anm
nb  ->  ao
nba  ->  aon
nbc  ->  aop
nbe  ->  aor
nbg  ->  aot
nbj  ->  aow
nbn  ->  aoa
nbp  ->  aoc
nbq  ->  aod
nbr  ->  aoe
nbt  ->  aog
nbv  ->  aoi
nbw  ->  aoj
nby  ->  aol
nc  ->  ap
nca  ->  apn
ncc  ->  app
nce  ->  apr
ncg  ->  apt
ncha  ->  apun
nchen  ->  apura
nchin  ->  apuva
nci  ->  apv
ncl  ->  apy
nclb  ->  apyo
nco  ->  apb
ncp  ->  apc
ncr  ->  ape
ncrna  ->  apean
ncrr  ->  apee
nct  ->  apg
ncx  ->  apk
nd  ->  aq
ndf  ->  aqs
ndn  ->  aqa
ndna  ->  aqan
ne  ->  ar
nea  ->  arn
neaf  ->  arns
neal  ->  arny
nean  ->  arna
neane  ->  arnar
near  ->  arne
neara  ->  arnen
neare  ->  arner
neary  ->  arnel
neat  ->  arng
neb  ->  aro
neba  ->  aron
nebat  ->  arong
nebb  ->  aroo
nebe  ->  aror
neben  ->  arora
nebn  ->  aroa
nebo  ->  arob
nebor  ->  arobe
nebs  ->  arof
nebu  ->  aroh
nebun  ->  aroha
nec  ->  arp
nech  ->  arpu
necne  ->  arpar
nee  ->  arr
neeb  ->  arro
neebor  ->  arrobe
neef  ->  arrs
neen  ->  arra
neer  ->  arre
neera  ->  arren
neere  ->  arrer
neev  ->  arri
nef  ->  ars
nefna  ->  arsan
nefnd  ->  arsaq
nefne  ->  arsar
neg  ->  art
neghe  ->  artur
negl  ->  arty
negr  ->  arte
negra  ->  arten
negrar  ->  artene
negre  ->  arter
negrean  ->  arterna
negrear  ->  arterne
negrer  ->  artere
negu  ->  arth
neguen  ->  arthra
negura  ->  arthen
neh  ->  aru
neha  ->  arun
nehan  ->  aruna
nei  ->  arv
neia  ->  arvn
neif  ->  arvs
neig  ->  arvt
neil  ->  arvy
nein  ->  arva
neir  ->  arve
neira  ->  arven
neiv  ->  arvi
neje  ->  arwr
nek  ->  arx
nel  ->  ary
nem  ->  arz
nemnan  ->  arzana
nemu  ->  arzh
nen  ->  ara
nena  ->  aran
nend  ->  araq
nene  ->  arar
nenen  ->  arara
neneng  ->  ararat
neng  ->  arat
nengen  ->  aratra
nenin  ->  arava
nenina  ->  aravan
nennen  ->  araara
neno  ->  arab
nens  ->  araf
nent  ->  arag
nenu  ->  arah
nenun  ->  araha
neo  ->  arb
neon  ->  arba
neona  ->  arban
neonan  ->  arbana
neor  ->  arbe
nep  ->  arc
nepen  ->  arcra
neph  ->  arcu
nepon  ->  arcba
nepun  ->  archa
neq  ->  ard
ner  ->  are
'ner  ->  'are
nera  ->  aren
nerba  ->  areon
nerd  ->  areq
nere  ->  arer
nerer  ->  arere
nerf  ->  ares
nerin  ->  areva
neron  ->  areba
nert  ->  areg
neru  ->  areh
nerv  ->  arei
nerw  ->  arej
nerx  ->  arek
nery  ->  arel
nerz  ->  arem
nes  ->  arf
nese  ->  arfr
nesne  ->  arfar
ness  ->  arff
net  ->  arg
nete  ->  argr
netgun  ->  argtha
neth  ->  argu
netna  ->  argan
neto  ->  argb
netra  ->  argen
netre  ->  arger
netu  ->  argh
netur  ->  arghe
netura  ->  arghen
neture  ->  argher
neu  ->  arh
nev  ->  ari
neva  ->  arin
nevaa  ->  arinn
nevan  ->  arina
nevana  ->  arinan
nevar  ->  arine
nevat  ->  aring
neven  ->  arira
never  ->  arire
nevn  ->  aria
nevna  ->  arian
nevo  ->  arib
nevon  ->  ariba
nevra  ->  arien
nevre  ->  arier
nevrer  ->  ariere
nevs  ->  arif
new  ->  arj
nex  ->  ark
ney  ->  arl
nez  ->  arm
neznan  ->  armana
nf  ->  as
nfa  ->  asn
nfc  ->  asp
nfd  ->  asq
nfg  ->  ast
nfi  ->  asv
nfj  ->  asw
nfk  ->  asx
nfl  ->  asy
nfr  ->  ase
nfs  ->  asf
nft  ->  asg
nfu  ->  ash
nfv  ->  asi
ng  ->  at
ngah  ->  atnu
ngan  ->  atna
nganz  ->  atnam
ngb  ->  ato
ngbs  ->  atof
ngc  ->  atp
nge  ->  atr
ngen  ->  atra
ngf  ->  ats
nghe  ->  atur
nghen  ->  atura
nghena  ->  aturan
ngi  ->  atv
ngl  ->  aty
ngm  ->  atz
ngn  ->  ata
ngo  ->  atb
ngp  ->  atc
ngr  ->  ate
ngre  ->  ater
ngreh  ->  ateru
ngs  ->  atf
ngt  ->  atg
ngu  ->  ath
nguba  ->  athon
ngugun  ->  aththa
ngul  ->  athy
ngun  ->  atha
ngura  ->  athen
nguy  ->  athl
ngy  ->  atl
nh  ->  au
nha  ->  aun
nham  ->  aunz
nhan  ->  auna
nhang  ->  aunat
nhar  ->  aune
nhc  ->  aup
nhe  ->  aur
nhee  ->  aurr
nhen  ->  aura
nhg  ->  aut
nhi  ->  auv
nhir  ->  auve
nhm  ->  auz
nhmn  ->  auza
nho  ->  aub
nhp  ->  auc
nhre  ->  auer
nhs  ->  auf
nht  ->  aug
nhu  ->  auh
nhw  ->  auj
nhyn  ->  aula
nhz  ->  aum
ni  ->  av
nia  ->  avn
nib  ->  avo
niba  ->  avon
nible  ->  avoyr
nic  ->  avp
nich  ->  avpu
nieb  ->  avro
nien  ->  avra
nienz  ->  avram
nier  ->  avre
niev  ->  avri
nieve  ->  avrir
nif  ->  avs
nih  ->  avu
niha  ->  avun
nihan  ->  avuna
nihl  ->  avuy
nin  ->  ava
nina  ->  avan
ninag  ->  avant
ninan  ->  avana
nine  ->  avar
niner  ->  avare
ning  ->  avat
ninin  ->  avava
ninna  ->  avaan
ninnin  ->  avaava
ninu  ->  avah
ninz  ->  avam
nip  ->  avc
niq  ->  avd
nir  ->  ave
nira  ->  aven
nire  ->  aver
niren  ->  avera
nirf  ->  aves
nit  ->  avg
nita  ->  avgn
nitre  ->  avger
niv  ->  avi
niva  ->  avin
nivan  ->  avina
nivar  ->  avine
nive  ->  avir
nivir  ->  avive
niy  ->  avl
niyo  ->  avlb
niz  ->  avm
nj  ->  aw
nja  ->  awn
njare  ->  awner
nje  ->  awr
njel  ->  awry
njen  ->  awra
njer  ->  awre
njnj  ->  awaw
njof  ->  awbs
njrf  ->  awes
nk  ->  ax
nke  ->  axr
nkr  ->  axe
nkro  ->  axeb
nkw  ->  axj
nl  ->  ay
nla  ->  ayn
nle  ->  ayr
nll  ->  ayy
nlp  ->  ayc
nlq  ->  ayd
nlr  ->  aye
nm  ->  az
nma  ->  azn
nmm  ->  azz
nmn  ->  aza
nmnm  ->  azaz
nmr  ->  aze
nmw  ->  azj
nn  ->  aa
nna  ->  aan
nnah  ->  aanu
nnan  ->  aana
nne  ->  aar
nngu  ->  aath
nnh  ->  aau
nni  ->  aav
nnif  ->  aavs
nnj  ->  aaw
nnp  ->  aac
nns  ->  aaf
nnt  ->  aag
nnu  ->  aah
no  ->  ab
noa  ->  abn
noar  ->  abne
nob  ->  abo
nobar  ->  abone
nobb  ->  aboo
nobba  ->  aboon
nobe  ->  abor
nobo  ->  abob
noc  ->  abp
nod  ->  abq
nodo  ->  abqb
noe  ->  abr
noel  ->  abry
noen  ->  abra
noer  ->  abre
noera  ->  abren
nof  ->  abs
nofrag  ->  absent
nog  ->  abt
nogra  ->  abten
noh  ->  abu
noha  ->  abun
nohe  ->  abur
nohea  ->  aburn
nohl  ->  abuy
noht  ->  abug
nohu  ->  abuh
noi  ->  abv
noj  ->  abw
nok  ->  abx
nol  ->  aby
nolba  ->  abyon
nolf  ->  abys
nomne  ->  abzar
non  ->  aba
nona  ->  aban
nonan  ->  abana
nonane  ->  abanar
nonanen  ->  abanara
nonary  ->  abanel
nonc  ->  abap
none  ->  abar
noneen  ->  abarra
nonen  ->  abara
nong  ->  abat
nongena  ->  abatran
nongra  ->  abaten
nonn  ->  abaa
nonner  ->  abaare
nono  ->  abab
nonu  ->  abah
nonveg  ->  abairt
nonyn  ->  abala
nonyne  ->  abalar
noo  ->  abb
noob  ->  abbo
nool  ->  abby
noon  ->  abba
noor  ->  abbe
nop  ->  abc
nor  ->  abe
nor'  ->  abe'
nora  ->  aben
norat  ->  abeng
norb  ->  abeo
nore  ->  aber
noreen  ->  aberra
noren  ->  abera
norena  ->  aberan
noret  ->  aberg
norne  ->  abear
norr  ->  abee
norry  ->  abeel
nort  ->  abeg
nory  ->  abel
nos  ->  abf
not  ->  abg
notre  ->  abger
nou  ->  abh
nouen  ->  abhra
noun  ->  abha
nounat  ->  abhang
nouny  ->  abhal
nov  ->  abi
nova  ->  abin
novan  ->  abina
novat  ->  abing
nove  ->  abir
noven  ->  abira
nover  ->  abire
novo  ->  abib
novor  ->  abibe
novy  ->  abil
nowhen  ->  abjura
nowhere  ->  abjurer
nox  ->  abk
noy  ->  abl
noyb  ->  ablo
noyl  ->  ably
noz  ->  abm
np  ->  ac
npc  ->  acp
npf  ->  acs
npg  ->  act
nph  ->  acu
npi  ->  acv
npk  ->  acx
npm  ->  acz
npn  ->  aca
npo  ->  acb
npp  ->  acc
npr  ->  ace
nps  ->  acf
npt  ->  acg
npu  ->  ach
npv  ->  aci
nq  ->  ad
nqe  ->  adr
nqena  ->  adran
nqenx  ->  adrak
nqf  ->  ads
nr  ->  ae
nra  ->  aen
nrab  ->  aeno
nrb  ->  aeo
nrc  ->  aep
nre  ->  aer
nrel  ->  aery
nrg  ->  aet
nri  ->  aev
nrj  ->  aew
nrn  ->  aea
nrna  ->  aean
nro  ->  aeb
nrs  ->  aef
nrsv  ->  aefi
nrt  ->  aeg
nrw  ->  aej
ns  ->  af
nsa  ->  afn
nsc  ->  afp
nsebaq  ->  afrond
nsf  ->  afs
nsh  ->  afu
nsi  ->  afv
nsn  ->  afa
nso  ->  afb
nsq  ->  afd
nsr  ->  afe
nsrna  ->  afean
nss  ->  aff
nssl  ->  affy
nst  ->  afg
nsv  ->  afi
nsw  ->  afj
nt  ->  ag
nta  ->  agn
ntaba  ->  agnon
ntangu  ->  agnath
ntb  ->  ago
ntc  ->  agp
nte  ->  agr
ntern  ->  agrea
ntev  ->  agri
ntf  ->  ags
ntg  ->  agt
nth  ->  agu
nti  ->  agv
ntj  ->  agw
ntl  ->  agy
ntlm  ->  agyz
nto  ->  agb
nton  ->  agba
ntp  ->  agc
ntr  ->  age
ntrj  ->  agew
ntry  ->  agel
ntt  ->  agg
nttn  ->  agga
ntu  ->  agh
ntw  ->  agj
nu  ->  ah
nua  ->  ahn
nuan  ->  ahna
nuar  ->  ahne
nub  ->  aho
nuba  ->  ahon
nubby  ->  ahool
nuby  ->  ahol
nuc  ->  ahp
nuch  ->  ahpu
nucha  ->  ahpun
nue  ->  ahr
nuef  ->  ahrs
nuer  ->  ahre
nuf  ->  ahs
nug  ->  aht
nuh  ->  ahu
nuha  ->  ahun
nuhu  ->  ahuh
nui  ->  ahv
nuib  ->  ahvo
nuira  ->  ahven
nul  ->  ahy
num  ->  ahz
nun  ->  aha
nuna  ->  ahan
nunan  ->  ahana
nunat  ->  ahang
nune  ->  ahar
nuneg  ->  ahart
nung  ->  ahat
nunn  ->  ahaa
nunna  ->  ahaan
nuno  ->  ahab
nunor  ->  ahabe
nunu  ->  ahah
nuo  ->  ahb
nur  ->  ahe
nura  ->  ahen
nure  ->  aher
nurea  ->  ahern
nurn  ->  ahea
nuu  ->  ahh
nuva  ->  ahin
nuve  ->  ahir
nuy  ->  ahl
nuz  ->  ahm
nv  ->  ai
nva  ->  ain
nvc  ->  aip
nvd  ->  aiq
nve  ->  air
nves  ->  airf
nvg  ->  ait
nvi  ->  aiv
nvm  ->  aiz
nvp  ->  aic
nvq  ->  aid
nvrm  ->  aiez
nw  ->  aj
nwa  ->  ajn
nwb  ->  ajo
nwbn  ->  ajoa
nwo  ->  ajb
nwr  ->  aje
nwx  ->  ajk
nwy  ->  ajl
nxb  ->  ako
nxiba  ->  akvon
ny  ->  al
nya  ->  aln
nyan  ->  alna
nyara  ->  alnen
nyc  ->  alp
nyce  ->  alpr
nycl  ->  alpy
nye  ->  alr
nygla  ->  altyn
nygren  ->  altera
nyi  ->  alv
nyib  ->  alvo
nyin  ->  alva
nyl  ->  aly
nym  ->  alz
nyn  ->  ala
nyna  ->  alan
nyne  ->  alar
nyo  ->  alb
nyon  ->  alba
nyong  ->  albat
nyova  ->  albin
nyr  ->  ale
nyra  ->  alen
nyre  ->  aler
nyren  ->  alera
nyrer  ->  alere
nyret  ->  alerg
nyrs  ->  alef
nys  ->  alf
nyse  ->  alfr
nysn  ->  alfa
nysna  ->  alfan
nyt  ->  alg
nyth  ->  algu
nyu  ->  alh
nyun  ->  alha
nyx  ->  alk
nyy  ->  all
nyyh  ->  allu
nyyn  ->  alla
nz  ->  am
nze  ->  amr
nzi  ->  amv
nzl  ->  amy
nzn  ->  ama
nznzn  ->  amama
o  ->  b
o'  ->  b'
oa  ->  bn
oab  ->  bno
oac  ->  bnp
oae  ->  bnr
oaf  ->  bns
oafs  ->  bnsf
oaj  ->  bnw
oan  ->  bna
oap  ->  bnc
oar  ->  bne
oard  ->  bneq
oas  ->  bnf
oav  ->  bni
ob  ->  bo
oba  ->  bon
obaba  ->  bonon
obal  ->  bony
oban  ->  bona
obana  ->  bonan
obang  ->  bonat
obar  ->  bone
obara  ->  bonen
obat  ->  bong
obava  ->  bonin
obb  ->  boo
obba  ->  boon
obbo  ->  boob
obby  ->  bool
obbyr  ->  boole
obc  ->  bop
obe  ->  bor
obea  ->  born
obeah  ->  bornu
obear  ->  borne
obeare  ->  borner
obeb  ->  boro
obeha  ->  borun
obel  ->  bory
oben  ->  bora
obeng  ->  borat
obeo  ->  borb
ober  ->  bore
obera  ->  boren
obere  ->  borer
oberra  ->  boreen
oberu  ->  boreh
obeu  ->  borh
obex  ->  bork
obez  ->  borm
obg  ->  bot
obi  ->  bov
obin  ->  bova
obj  ->  bow
obla  ->  boyn
oble  ->  boyr
obna  ->  boan
obo  ->  bob
oboe  ->  bobr
oboen  ->  bobra
oboer  ->  bobre
obol  ->  boby
obole  ->  bobyr
obon  ->  boba
oboo  ->  bobb
obor  ->  bobe
obora  ->  boben
oboy  ->  bobl
obp  ->  boc
obr  ->  boe
obra  ->  boen
obrar  ->  boene
obrara  ->  boenen
obre  ->  boer
obren  ->  boera
obrer  ->  boere
obrera  ->  boeren
obrir  ->  boeve
obrt  ->  boeg
obrv  ->  boei
obry  ->  boel
obs  ->  bof
obsere  ->  bofrer
obter  ->  bogre
obu  ->  boh
obua  ->  bohn
obue  ->  bohr
obul  ->  bohy
obuv  ->  bohi
obuz  ->  bohm
obvier  ->  boivre
obvy  ->  boil
obx  ->  bok
oby  ->  bol
obzor  ->  bombe
oc  ->  bp
ocb  ->  bpo
occ  ->  bpp
occi  ->  bppv
oce  ->  bpr
ocn  ->  bpa
oco  ->  bpb
ocp  ->  bpc
ocs  ->  bpf
ocu  ->  bph
od  ->  bq
odf  ->  bqs
odr  ->  bqe
oe  ->  br
oea  ->  brn
oeb  ->  bro
oec  ->  brp
oee  ->  brr
oef  ->  brs
oei  ->  brv
oek  ->  brx
oel  ->  bry
oela  ->  bryn
oels  ->  bryf
oem  ->  brz
oen  ->  bra
oena  ->  bran
oene  ->  brar
oenin  ->  brava
oenu  ->  brah
oer  ->  bre
oere  ->  brer
oeri  ->  brev
oerle  ->  breyr
oeru  ->  breh
oeu  ->  brh
oev  ->  bri
oevra  ->  brien
oevre  ->  brier
oevrer  ->  briere
oevs  ->  brif
of  ->  bs
ofa  ->  bsn
ofc  ->  bsp
off  ->  bss
ofn  ->  bsa
ofr  ->  bse
ofs  ->  bsf
oft  ->  bsg
og  ->  bt
oga  ->  btn
ogc  ->  btp
ogg  ->  btt
ogh  ->  btu
ogn  ->  bta
ogo  ->  btb
ogon  ->  btba
ogr  ->  bte
ogu  ->  bth
ogun  ->  btha
oh  ->  bu
oha  ->  bun
ohana  ->  bunan
ohar  ->  bune
ohc  ->  bup
ohd  ->  buq
ohe  ->  bur
ohea  ->  burn
ohean  ->  burna
oheen  ->  burra
ohel  ->  bury
ohen  ->  bura
ohene  ->  burar
ohenen  ->  burara
oheni  ->  burav
ohg  ->  but
ohh  ->  buu
ohk  ->  bux
ohm  ->  buz
ohn  ->  bua
ohne  ->  buar
ohni  ->  buav
ohnu  ->  buah
oho  ->  bub
ohoh  ->  bubu
ohon  ->  buba
ohone  ->  bubar
ohp  ->  buc
ohr  ->  bue
ohra  ->  buen
ohran  ->  buena
ohre  ->  buer
ohrs  ->  buef
ohs  ->  buf
oht  ->  bug
ohta  ->  bugn
ohu  ->  buh
ohui  ->  buhv
ohyb  ->  bulo
oi  ->  bv
oic  ->  bvp
oie  ->  bvr
oit  ->  bvg
oj  ->  bw
oja  ->  bwn
oje  ->  bwr
ojej  ->  bwrw
oji  ->  bwv
ojo  ->  bwb
ojr  ->  bwe
ok  ->  bx
okb  ->  bxo
ol  ->  by
ola  ->  byn
olaf  ->  byns
olan  ->  byna
olat  ->  byng
olc  ->  byp
ole  ->  byr
olea  ->  byrn
olear  ->  byrne
olee  ->  byrr
oler  ->  byre
olet  ->  byrg
olev  ->  byri
olew  ->  byrj
olf  ->  bys
ol'g  ->  by't
olg  ->  byt
olg'  ->  byt'
olgu  ->  byth
olh  ->  byu
olha  ->  byun
olier  ->  byvre
olj  ->  byw
olob  ->  bybo
olov  ->  bybi
ols  ->  byf
olt  ->  byg
oltavat  ->  bygning
oltra  ->  bygen
oltre  ->  byger
oly  ->  byl
om  ->  bz
omba  ->  bzon
omc  ->  bzp
oml  ->  bzy
omm  ->  bzz
omval  ->  bziny
omw  ->  bzj
on  ->  ba
'on  ->  'ba
ona  ->  ban
onagra  ->  banten
onagre  ->  banter
onan  ->  bana
onana  ->  banan
onar  ->  bane
onaur  ->  banhe
onc  ->  bap
onche  ->  bapur
onden  ->  baqra
one  ->  bar
'one  ->  'bar
onea  ->  barn
onee  ->  barr
oneer  ->  barre
oneg  ->  bart
onejar  ->  barwne
onela  ->  baryn
onen  ->  bara
oneng  ->  barat
oneo  ->  barb
oneone  ->  barbar
oner  ->  bare
onera  ->  baren
onerar  ->  barene
onerat  ->  bareng
onere  ->  barer
onerer  ->  barere
onerva  ->  barein
onery  ->  barel
ones  ->  barf
oneth  ->  bargu
ong  ->  bat
ongan  ->  batna
ongen  ->  batra
onger  ->  batre
ongl  ->  baty
ongni  ->  batav
ongs  ->  batf
ongu  ->  bath
ongul  ->  bathy
onhan  ->  bauna
oni  ->  bav
onin  ->  bava
onj  ->  baw
onja  ->  bawn
onk  ->  bax
onlar  ->  bayne
onlend  ->  bayraq
onm  ->  baz
onn  ->  baa
onna  ->  baan
onnan  ->  baana
onne  ->  baar
onnea  ->  baarn
onnen  ->  baara
onnor  ->  baabe
onnu  ->  baah
onnur  ->  baahe
ono  ->  bab
onon  ->  baba
onona  ->  baban
ononan  ->  babana
ononin  ->  babava
onor  ->  babe
onora  ->  baben
onore  ->  baber
onp  ->  bac
onpa  ->  bacn
onpu  ->  bach
onra  ->  baen
onry  ->  bael
ons  ->  baf
ont  ->  bag
onta  ->  bagn
ontan  ->  bagna
onte  ->  bagr
onterf  ->  bagres
ontre  ->  bager
onu  ->  bah
onuba  ->  bahon
onun  ->  baha
onur  ->  bahe
onwere  ->  bajrer
ony  ->  bal
onyo  ->  balb
onyon  ->  balba
onyor  ->  balbe
onyx  ->  balk
onz  ->  bam
oo  ->  bb
ooa  ->  bbn
ooc  ->  bbp
ood  ->  bbq
oof  ->  bbs
oog  ->  bbt
oon  ->  bba
oone  ->  bbar
ooo  ->  bbb
oop  ->  bbc
oor  ->  bbe
oore  ->  bber
oot  ->  bbg
oov  ->  bbi
ooy  ->  bbl
op  ->  bc
opa  ->  bcn
opah  ->  bcnu
opas  ->  bcnf
opc  ->  bcp
ope  ->  bcr
opi  ->  bcv
opin  ->  bcva
opn  ->  bca
opo  ->  bcb
opot  ->  bcbg
opp  ->  bcc
ops  ->  bcf
opt  ->  bcg
opv  ->  bci
opy  ->  bcl
oq  ->  bd
oqi  ->  bdv
oqr  ->  bde
or  ->  be
ora  ->  ben
oraa  ->  benn
oraal  ->  benny
oraan  ->  benna
oraba  ->  benon
orabar  ->  benone
orah  ->  benu
orajn  ->  benwa
orala  ->  benyn
oram  ->  benz
oran  ->  bena
orana  ->  benan
orane  ->  benar
orang  ->  benat
oranz  ->  benam
oraq  ->  bend
orar  ->  bene
orara  ->  benen
orare  ->  bener
oraria  ->  benevn
orat  ->  beng
orav  ->  beni
orava  ->  benin
oravan  ->  benina
oravat  ->  bening
orb  ->  beo
orba  ->  beon
orbe  ->  beor
orbet  ->  beorg
orby  ->  beol
orc  ->  bep
ord  ->  beq
ordne  ->  beqar
ore  ->  ber
orea  ->  bern
oreaba  ->  bernon
orean  ->  berna
orear  ->  berne
oreara  ->  bernen
oreare  ->  berner
orearen  ->  bernera
oreb  ->  bero
oree  ->  berr
oreen  ->  berra
oreg  ->  bert
oreh  ->  beru
orej  ->  berw
orek  ->  berx
orel  ->  bery
orem  ->  berz
oren  ->  bera
orena  ->  beran
orene  ->  berar
orent  ->  berag
orer  ->  bere
orera  ->  beren
ores  ->  berf
oret  ->  berg
orete  ->  bergr
orez  ->  berm
orf  ->  bes
orfen  ->  besra
org  ->  bet
orge  ->  betr
orgene  ->  betrar
orgle  ->  betyr
orgne  ->  betar
orgul  ->  bethy
orgun  ->  betha
orgy  ->  betl
orgyn  ->  betla
ori  ->  bev
oribe  ->  bevor
orier  ->  bevre
oriere  ->  bevrer
oril  ->  bevy
orile  ->  bevyr
orin  ->  beva
orina  ->  bevan
orine  ->  bevar
orinen  ->  bevara
orire  ->  bever
orirer  ->  bevere
orirere  ->  beverer
orj  ->  bew
orjo  ->  bewb
orl  ->  bey
orla  ->  beyn
orlaba  ->  beynon
orlar  ->  beyne
orlat  ->  beyng
orlava  ->  beynin
orly  ->  beyl
orm  ->  bez
ormr  ->  beze
orn  ->  bea
orna  ->  bean
ornan  ->  beana
ornar  ->  beane
ornara  ->  beanen
ornare  ->  beaner
orne  ->  bear
ornee  ->  bearr
orneg  ->  beart
orner  ->  beare
ornera  ->  bearen
ornere  ->  bearer
ornet  ->  bearg
ornez  ->  bearm
orning  ->  beavat
orno  ->  beab
ornu  ->  beah
orny  ->  beal
oro  ->  beb
oron  ->  beba
orona  ->  beban
oror  ->  bebe
orphan  ->  becuna
orqan  ->  bedna
orr  ->  bee
orra  ->  been
orrar  ->  beene
orre  ->  beer
orrel  ->  beery
orren  ->  beera
orrir  ->  beeve
orrire  ->  beever
orro  ->  beeb
orror  ->  beebe
ors  ->  bef
ort  ->  beg
ortel  ->  begry
orten  ->  begra
orter  ->  begre
ortha  ->  begun
ortt  ->  begg
oru  ->  beh
orun  ->  beha
orv  ->  bei
orve  ->  beir
oryl  ->  bely
oryx  ->  belk
orz  ->  bem
os  ->  bf
osc  ->  bfp
ose  ->  bfr
osf  ->  bfs
osn  ->  bfa
osp  ->  bfc
ospf  ->  bfcs
oss  ->  bff
ost  ->  bfg
osu  ->  bfh
osv  ->  bfi
o't  ->  b'g
ot  ->  bg
ota  ->  bgn
otc  ->  bgp
ote  ->  bgr
otg  ->  bgt
oth  ->  bgu
oto  ->  bgb
otr  ->  bge
otre  ->  bger
otu  ->  bgh
ou  ->  bh
oue  ->  bhr
ouf  ->  bhs
oug  ->  bht
ouh  ->  bhu
ouo  ->  bhb
ov  ->  bi
ova  ->  bin
ovaal  ->  binny
ovaba  ->  binon
ovabo  ->  binob
ovan  ->  bina
ovana  ->  binan
ovane  ->  binar
ovar  ->  bine
ovara  ->  binen
ovare  ->  biner
ovat  ->  bing
ovatu  ->  bingh
ovava  ->  binin
ovc  ->  bip
ove  ->  bir
ovea  ->  birn
oveen  ->  birra
oven  ->  bira
ovena  ->  biran
over  ->  bire
overa  ->  biren
overe  ->  birer
ovet  ->  birg
ovi  ->  biv
ovin  ->  biva
ovn  ->  bia
ovna  ->  bian
ovne  ->  biar
ovnen  ->  biara
ovo  ->  bib
ovon  ->  biba
ovoo  ->  bibb
ovor  ->  bibe
ovp  ->  bic
ovra  ->  bien
ovrar  ->  biene
ovrer  ->  biere
ovrier  ->  bievre
ovro  ->  bieb
ovs  ->  bif
ovu  ->  bih
ovve  ->  biir
ovy  ->  bil
ow  ->  bj
owa  ->  bjn
own  ->  bja
ows  ->  bjf
oww  ->  bjj
ox  ->  bk
oxa  ->  bkn
oxi  ->  bkv
oy  ->  bl
oya  ->  bln
oye  ->  blr
oyj  ->  blw
oyl  ->  bly
oyna  ->  blan
oyne  ->  blar
oyo  ->  blb
oyr  ->  ble
oyra  ->  blen
oyri  ->  blev
oz  ->  bm
ozi  ->  bmv
ozn  ->  bma
ozr  ->  bme
ozvat  ->  bming
p  ->  c
p'  ->  c'
p'a  ->  c'n
pa  ->  cn
paa  ->  cnn
pab  ->  cno
pac  ->  cnp
pae  ->  cnr
paf  ->  cns
paff  ->  cnss
pag  ->  cnt
pagi  ->  cntv
pahq  ->  cnud
pai  ->  cnv
pak  ->  cnx
pal  ->  cny
pan  ->  cna
panh  ->  cnau
panir  ->  cnave
pann  ->  cnaa
pant  ->  cnag
pap  ->  cnc
paps  ->  cncf
paq  ->  cnd
par  ->  cne
pas  ->  cnf
pat  ->  cng
pau  ->  cnh
pav  ->  cni
pavs  ->  cnif
pay  ->  cnl
pb  ->  co
pba  ->  con
pban  ->  cona
pbar  ->  cone
pbas  ->  conf
pbb  ->  coo
pbbs  ->  coof
pbc  ->  cop
pbf  ->  cos
pbg  ->  cot
pbgv  ->  coti
pbh  ->  cou
pbi  ->  cov
pbj  ->  cow
pbm  ->  coz
pbn  ->  coa
pbo  ->  cob
pbp  ->  coc
pbq  ->  cod
pbr  ->  coe
pbs  ->  cof
pbt  ->  cog
pbu  ->  coh
pbx  ->  cok
pbz  ->  com
pc  ->  cp
pca  ->  cpn
pcb  ->  cpo
pcc  ->  cpp
pce  ->  cpr
pcg  ->  cpt
pch  ->  cpu
pci  ->  cpv
pcn  ->  cpa
pco  ->  cpb
pcp  ->  cpc
pcr  ->  cpe
pcs  ->  cpf
pct  ->  cpg
pcv  ->  cpi
pcx  ->  cpk
pd  ->  cq
pdo  ->  cqb
pdp  ->  cqc
pdq  ->  cqd
pe  ->  cr
pea  ->  crn
pean  ->  crna
peb  ->  cro
peba  ->  cron
peber  ->  crore
pec  ->  crp
peery  ->  crrel
peg  ->  crt
pegh  ->  crtu
pegn  ->  crta
peh  ->  cru
pehar  ->  crune
pehr  ->  crue
pei  ->  crv
pein  ->  crva
peiran  ->  crvena
peja  ->  crwn
pel  ->  cry
pela  ->  cryn
pelaje  ->  crynwr
pelb  ->  cryo
pelf  ->  crys
pelna  ->  cryan
pelq  ->  cryd
pels  ->  cryf
pen  ->  cra
pena  ->  cran
penar  ->  crane
penare  ->  craner
penat  ->  crang
penel  ->  crary
pener  ->  crare
penful  ->  crashy
peng  ->  crat
penha  ->  craun
penin  ->  crava
pening  ->  cravat
penir  ->  crave
penja  ->  crawn
penk  ->  crax
pennar  ->  craane
penny  ->  craal
peno  ->  crab
penon  ->  craba
penore  ->  craber
pens  ->  craf
pent  ->  crag
pentre  ->  crager
pentref  ->  cragers
penu  ->  crah
penz  ->  cram
peo  ->  crb
pep  ->  crc
per  ->  cre
pera  ->  cren
peran  ->  crena
perang  ->  crenat
perbe  ->  creor
perc  ->  crep
perch  ->  crepu
perche  ->  crepur
percre  ->  creper
pere  ->  crer
pereba  ->  creron
peren  ->  crera
perena  ->  creran
perera  ->  creren
perf  ->  cres
perh  ->  creu
peri  ->  crev
perin  ->  creva
perina  ->  crevan
perine  ->  crevar
perir  ->  creve
perire  ->  crever
perj  ->  crew
perk  ->  crex
perm  ->  crez
pern  ->  crea
perna  ->  crean
perne  ->  crear
pernear  ->  crearne
pernera  ->  crearen
pernere  ->  crearer
pernerer  ->  crearere
pernt  ->  creag
perob  ->  crebo
peron  ->  creba
perona  ->  creban
perone  ->  crebar
perora  ->  creben
perore  ->  creber
perp  ->  crec
perq  ->  cred
perr  ->  cree
perra  ->  creen
perre  ->  creer
perry  ->  creel
pers  ->  cref
pert  ->  creg
pertre  ->  creger
perv  ->  crei
pervy  ->  creil
perz  ->  crem
pes  ->  crf
peu  ->  crh
pev  ->  cri
pevar  ->  crine
pey  ->  crl
peyn  ->  crla
pez  ->  crm
pezo  ->  crmb
pf  ->  cs
pfb  ->  cso
pfc  ->  csp
pff  ->  css
pfff  ->  csss
pfi  ->  csv
pfk  ->  csx
pfp  ->  csc
pfs  ->  csf
pft  ->  csg
pfv  ->  csi
pfy  ->  csl
pg  ->  ct
pga  ->  ctn
pgc  ->  ctp
pgf  ->  cts
pgi  ->  ctv
pgm  ->  ctz
pgp  ->  ctc
pgps  ->  ctcf
pgr  ->  cte
pgs  ->  ctf
pgy  ->  ctl
ph  ->  cu
pha  ->  cun
phaal  ->  cunny
phager  ->  cuntre
phah  ->  cunu
phal  ->  cuny
phan  ->  cuna
phane  ->  cunar
phar  ->  cune
phara  ->  cunen
pharr  ->  cunee
phat  ->  cung
phau  ->  cunh
phb  ->  cuo
phe  ->  cur
phebe  ->  curor
pheer  ->  curre
pheha  ->  curun
phemba  ->  curzon
phen  ->  cura
phene  ->  curar
phenone  ->  curabar
pheny  ->  cural
pheo  ->  curb
pheon  ->  curba
phet  ->  curg
phev  ->  curi
phf  ->  cus
phi  ->  cuv
phin  ->  cuva
phl  ->  cuy
phm  ->  cuz
phn  ->  cua
pho  ->  cub
phoh  ->  cubu
phon  ->  cuba
phona  ->  cuban
phone  ->  cubar
phoner  ->  cubare
phong  ->  cubat
php  ->  cuc
phr  ->  cue
phra  ->  cuen
phren  ->  cuera
pht  ->  cug
phu  ->  cuh
phv  ->  cui
phvs  ->  cuif
phx  ->  cuk
phy  ->  cul
phyi  ->  culv
phyz  ->  culm
phz  ->  cum
pi  ->  cv
pia  ->  cvn
piaf  ->  cvns
pic  ->  cvp
pie  ->  cvr
pief  ->  cvrs
pif  ->  cvs
pig  ->  cvt
pii  ->  cvv
pik  ->  cvx
pim  ->  cvz
pin  ->  cva
ping  ->  cvat
piny  ->  cval
pip  ->  cvc
pir  ->  cve
pirg  ->  cvet
piv  ->  cvi
pj  ->  cw
pjo  ->  cwb
pjt  ->  cwg
pk  ->  cx
pkp  ->  cxc
pkr  ->  cxe
pks  ->  cxf
pl  ->  cy
pla  ->  cyn
plaba  ->  cynon
plag  ->  cynt
plan  ->  cyna
planar  ->  cynane
planen  ->  cynara
plat  ->  cyng
plav  ->  cyni
plavat  ->  cyning
plavba  ->  cynion
plb  ->  cyo
plc  ->  cyp
ple  ->  cyr
plea  ->  cyrn
pleb  ->  cyro
plee  ->  cyrr
plena  ->  cyran
plep  ->  cyrc
pler  ->  cyre
plera  ->  cyren
ples  ->  cyrf
pless  ->  cyrff
plev  ->  cyri
plevy  ->  cyril
plex  ->  cyrk
pley  ->  cyrl
plf  ->  cys
plir  ->  cyve
pln  ->  cya
plop  ->  cybc
plore  ->  cyber
plp  ->  cyc
plq  ->  cyd
pls  ->  cyf
plss  ->  cyff
plz  ->  cym
pm  ->  cz
pmg  ->  czt
pmhx  ->  czuk
pml  ->  czy
pmr  ->  cze
pn  ->  ca
pna  ->  can
pnb  ->  cao
pnc  ->  cap
pnd  ->  caq
pne  ->  car
pnf  ->  cas
png  ->  cat
pni  ->  cav
pnl  ->  cay
pnm  ->  caz
pnn  ->  caa
pnns  ->  caaf
pnp  ->  cac
pnq  ->  cad
pnr  ->  cae
pns  ->  caf
pnss  ->  caff
pnu  ->  cah
pnv  ->  cai
pnw  ->  caj
pnyx  ->  calk
po  ->  cb
poa  ->  cbn
pob  ->  cbo
pobe  ->  cbor
poc  ->  cbp
pocc  ->  cbpp
pod  ->  cbq
poe  ->  cbr
poea  ->  cbrn
pof  ->  cbs
pofa  ->  cbsn
pog  ->  cbt
pon  ->  cba
pone  ->  cbar
poop  ->  cbbc
pop  ->  cbc
por  ->  cbe
pore  ->  cber
pos  ->  cbf
pot  ->  cbg
pov  ->  cbi
pow  ->  cbj
poz  ->  cbm
pp  ->  cc
ppa  ->  ccn
ppb  ->  cco
ppc  ->  ccp
ppd  ->  ccq
ppe  ->  ccr
ppf  ->  ccs
ppg  ->  cct
pph  ->  ccu
ppi  ->  ccv
ppl  ->  ccy
ppn  ->  cca
ppo  ->  ccb
ppp  ->  ccc
ppq  ->  ccd
ppr  ->  cce
pps  ->  ccf
ppt  ->  ccg
pptp  ->  ccgc
ppv  ->  cci
ppw  ->  ccj
pq  ->  cd
pqn  ->  cda
pqp  ->  cdc
pqq  ->  cdd
pqs  ->  cdf
pqt  ->  cdg
pr  ->  ce
pra  ->  cen
praa  ->  cenn
praal  ->  cenny
praan  ->  cenna
praf  ->  cens
prag  ->  cent
prager  ->  centre
prah  ->  cenu
pral  ->  ceny
pran  ->  cena
prana  ->  cenan
prane  ->  cenar
prang  ->  cenat
pranu  ->  cenah
prat  ->  ceng
pratu  ->  cengh
prau  ->  cenh
prav  ->  ceni
prb  ->  ceo
prc  ->  cep
prcu  ->  ceph
prcv  ->  cepi
pre  ->  cer
prea  ->  cern
preab  ->  cerno
prean  ->  cerna
prear  ->  cerne
preara  ->  cernen
preare  ->  cerner
prearen  ->  cernera
prearm  ->  cernez
prebar  ->  cerone
prebe  ->  ceror
preen  ->  cerra
preener  ->  cerrare
pref  ->  cers
preg  ->  cert
pregna  ->  certan
pregu  ->  certh
preh  ->  ceru
prein  ->  cerva
prej  ->  cerw
prela  ->  ceryn
pren  ->  cera
prener  ->  cerare
preng  ->  cerat
prenu  ->  cerah
preo  ->  cerb
preon  ->  cerba
prep  ->  cerc
prepun  ->  cercha
prepuna  ->  cerchan
prepune  ->  cerchar
prere  ->  cerer
prerna  ->  cerean
pres  ->  cerf
prev  ->  ceri
preve  ->  cerir
prex  ->  cerk
prg  ->  cet
prh  ->  ceu
pri  ->  cev
pril  ->  cevy
prin  ->  ceva
princ  ->  cevap
prine  ->  cevar
pring  ->  cevat
prinz  ->  cevam
priv  ->  cevi
prj  ->  cew
prk  ->  cex
prm  ->  cez
prn  ->  cea
prob  ->  cebo
proba  ->  cebon
probat  ->  cebong
probyn  ->  cebola
pron  ->  ceba
prona  ->  ceban
pronar  ->  cebane
prone  ->  cebar
proner  ->  cebare
pror  ->  cebe
prora  ->  ceben
prore  ->  ceber
prov  ->  cebi
provar  ->  cebine
prp  ->  cec
prpr  ->  cece
prr  ->  cee
prs  ->  cef
prsa  ->  cefn
prse  ->  cefr
prt  ->  ceg
pru  ->  ceh
prv  ->  cei
pry  ->  cel
pryf  ->  cels
pryna  ->  celan
prynon  ->  celaba
prys  ->  celf
pryv  ->  celi
ps  ->  cf
psa  ->  cfn
psb  ->  cfo
pse  ->  cfr
psg  ->  cft
psn  ->  cfa
psni  ->  cfav
psp  ->  cfc
pst  ->  cfg
psu  ->  cfh
psv  ->  cfi
psx  ->  cfk
psy  ->  cfl
pt  ->  cg
pta  ->  cgn
ptb  ->  cgo
ptc  ->  cgp
pto  ->  cgb
ptpp  ->  cgcc
ptr  ->  cge
ptw  ->  cgj
p'u  ->  c'h
pu  ->  ch
pua  ->  chn
pu'an  ->  ch'na
pub  ->  cho
pubar  ->  chone
pubba  ->  choon
pube  ->  chor
puben  ->  chora
pubene  ->  chorar
puber  ->  chore
pubi  ->  chov
pubin  ->  chova
pubo  ->  chob
pubon  ->  choba
puc  ->  chp
pue  ->  chr
puen  ->  chra
puera  ->  chren
puf  ->  chs
pug  ->  cht
puh  ->  chu
puha  ->  chun
puhe  ->  chur
puheen  ->  churra
puhl  ->  chuy
puho  ->  chub
puhuen  ->  chuhra
puing  ->  chvat
puj  ->  chw
pul  ->  chy
pula  ->  chyn
pulaar  ->  chynne
pulan  ->  chyna
pular  ->  chyne
pulcer  ->  chypre
pulen  ->  chyra
puler  ->  chyre
pulo  ->  chyb
pulon  ->  chyba
pulzar  ->  chymne
pum  ->  chz
pun  ->  cha
puna  ->  chan
punaan  ->  channa
punac  ->  chanp
punah  ->  chanu
punan  ->  chana
punana  ->  chanan
punane  ->  chanar
punar  ->  chane
punat  ->  chang
punc  ->  chap
punch  ->  chapu
punche  ->  chapur
pune  ->  char
punel  ->  chary
punen  ->  chara
punent  ->  charag
pung  ->  chat
pungeva  ->  chatrin
pungg  ->  chatt
pungu  ->  chath
punh  ->  chau
punha  ->  chaun
puni  ->  chav
punien  ->  chavra
punin  ->  chava
punir  ->  chave
puniran  ->  chavena
punire  ->  chaver
punirer  ->  chavere
puniva  ->  chavin
punivere  ->  chavirer
punja  ->  chawn
punla  ->  chayn
punnat  ->  chaang
punnd  ->  chaaq
puno  ->  chab
punon  ->  chaba
puns  ->  chaf
puntaba  ->  chagnon
puntan  ->  chagna
punten  ->  chagra
punu  ->  chah
punx  ->  chak
punxen  ->  chakra
puny  ->  chal
punyir  ->  chalve
punys  ->  chalf
puo  ->  chb
pupu  ->  chch
puq  ->  chd
pur  ->  che
pura  ->  chen
puran  ->  chena
purat  ->  cheng
purava  ->  chenin
purba  ->  cheon
pure  ->  cher
purear  ->  cherne
purely  ->  cheryl
puren  ->  chera
purer  ->  chere
purerer  ->  cherere
pures  ->  cherf
purey  ->  cherl
purgan  ->  chetna
puri  ->  chev
purif  ->  chevs
puril  ->  chevy
purja  ->  chewn
purnaa  ->  cheann
puro  ->  cheb
puron  ->  cheba
purp  ->  chec
purpnin  ->  checava
purpu  ->  chech
purpur  ->  cheche
purpura  ->  chechen
purpuran  ->  chechena
purr  ->  chee
purre  ->  cheer
purrel  ->  cheery
purrer  ->  cheere
purrs  ->  cheef
purry  ->  cheel
purs  ->  chef
purter  ->  chegre
purva  ->  chein
purvs  ->  cheif
puryc  ->  chelp
pus  ->  chf
put  ->  chg
puu  ->  chh
puuha  ->  chhun
puur  ->  chhe
puve  ->  chir
puvi  ->  chiv
puy  ->  chl
puyl  ->  chly
pv  ->  ci
pva  ->  cin
pvc  ->  cip
pvd  ->  ciq
pve  ->  cir
pvf  ->  cis
pvn  ->  cia
pvoh  ->  cibu
pvp  ->  cic
pvr  ->  cie
pvrs  ->  cief
pvs  ->  cif
pvt  ->  cig
pvv  ->  cii
pvx  ->  cik
pw  ->  cj
pwnc  ->  cjap
px  ->  ck
py  ->  cl
pya  ->  cln
pyc  ->  clp
pye  ->  clr
pyf  ->  cls
pyg  ->  clt
pyh  ->  clu
pyi  ->  clv
pyk  ->  clx
pyl  ->  cly
pyn  ->  cla
pyne  ->  clar
pyni  ->  clav
pyning  ->  clavat
pynj  ->  claw
pynne  ->  claar
pynt  ->  clag
pyo  ->  clb
pyr  ->  cle
pyran  ->  clena
pyre  ->  cler
pyrex  ->  clerk
pyri  ->  clev
pyrz  ->  clem
pys  ->  clf
pyt  ->  clg
pyx  ->  clk
pyy  ->  cll
pz  ->  cm
pzas  ->  cmnf
pzb  ->  cmo
pze  ->  cmr
pzn  ->  cma
pzp  ->  cmc
q  ->  d
qa  ->  dn
qab  ->  dno
qac  ->  dnp
qad  ->  dnq
qah  ->  dnu
qaj  ->  dnw
qal  ->  dny
qam  ->  dnz
qan  ->  dna
qap  ->  dnc
qaq  ->  dnd
qar  ->  dne
qarz  ->  dnem
qas  ->  dnf
qat  ->  dng
qau  ->  dnh
qb  ->  do
qbb  ->  doo
qbd  ->  doq
qbh  ->  dou
qbo  ->  dob
qbs  ->  dof
qbt  ->  dog
qbw  ->  doj
qc  ->  dp
qccq  ->  dppd
qd  ->  dq
qe  ->  dr
qec  ->  drp
qef  ->  drs
qehbe  ->  druor
qehf  ->  drus
qejf  ->  drws
qel  ->  dry
qela  ->  dryn
qelt  ->  dryg
qen  ->  dra
qene  ->  drar
qenl  ->  dray
qens  ->  draf
qep  ->  drc
qerf  ->  dres
qert  ->  dreg
qey  ->  drl
qfe  ->  dsr
qg  ->  dt
qga  ->  dtn
qgp  ->  dtc
qgs  ->  dtf
qh  ->  du
qha  ->  dun
qhaba  ->  dunon
qhap  ->  dunc
qhaqha  ->  dundun
qhat  ->  dung
qhatha  ->  dungun
qhd  ->  duq
qhina  ->  duvan
qhl  ->  duy
qhov  ->  dubi
qht  ->  dug
qhuav  ->  duhni
qhuba  ->  duhon
qhura  ->  duhen
qi  ->  dv
qie  ->  dvr
qin  ->  dva
qio  ->  dvb
qiz  ->  dvm
ql  ->  dy
qlc  ->  dyp
qm  ->  dz
qn  ->  da
qnb  ->  dao
qnbt  ->  daog
qnd  ->  daq
qne  ->  dar
qneh  ->  daru
qnh  ->  dau
qnj  ->  daw
qnjt  ->  dawg
qnt  ->  dag
qnw  ->  daj
qo  ->  db
qoa  ->  dbn
qod  ->  dbq
qof  ->  dbs
qon  ->  dba
qop  ->  dbc
qoq  ->  dbd
qor  ->  dbe
qos  ->  dbf
qoz  ->  dbm
qpf  ->  dcs
qpp  ->  dcc
qpr  ->  dce
qq  ->  dd
qqn  ->  dda
qr  ->  de
qra  ->  den
qral  ->  deny
qrf  ->  des
qrft  ->  desg
qrg  ->  det
qrh  ->  deu
qri  ->  dev
qrib  ->  devo
qrj  ->  dew
qrk  ->  dex
qrl  ->  dey
qrm  ->  dez
qrn  ->  dea
qro  ->  deb
qrp  ->  dec
qrper  ->  decre
qrq  ->  ded
qrr  ->  dee
qrrt  ->  deeg
qrs  ->  def
qrss  ->  deff
qrt  ->  deg
qru  ->  deh
qrun  ->  deha
qrv  ->  dei
qrw  ->  dej
qrx  ->  dek
qrz  ->  dem
qs  ->  df
qsg  ->  dft
qsi  ->  dfv
qsn  ->  dfa
qso  ->  dfb
qsp  ->  dfc
qsr  ->  dfe
qsy  ->  dfl
qsz  ->  dfm
qt  ->  dg
qta  ->  dgn
qtf  ->  dgs
qtl  ->  dgy
qto  ->  dgb
qtz  ->  dgm
qu  ->  dh
qu'  ->  dh'
quag  ->  dhnt
qub  ->  dho
qubbe  ->  dhoor
quc  ->  dhp
que  ->  dhr
quer  ->  dhre
quf  ->  dhs
quhen  ->  dhura
quho  ->  dhub
qui  ->  dhv
qum  ->  dhz
qun  ->  dha
qunc  ->  dhap
qur  ->  dhe
qurm  ->  dhez
qurt  ->  dheg
quru  ->  dheh
qv  ->  di
qvar  ->  dine
qvl  ->  diy
qvt  ->  dig
qye  ->  dlr
qyl  ->  dly
qyr  ->  dle
r  ->  e
r'  ->  e'
'r  ->  'e
ra  ->  en
raa  ->  enn
raab  ->  enno
raabt  ->  ennog
raaf  ->  enns
raal  ->  enny
raan  ->  enna
raar  ->  enne
raara  ->  ennen
raare  ->  enner
raav  ->  enni
rab  ->  eno
raba  ->  enon
raban  ->  enona
rabar  ->  enone
rabe  ->  enor
rabere  ->  enorer
raby  ->  enol
racler  ->  enpyre
raf  ->  ens
rag  ->  ent
ragel  ->  entry
ragen  ->  entra
rager  ->  entre
ragera  ->  entren
ragn  ->  enta
ragna  ->  entan
ragr  ->  ente
rags  ->  entf
rah  ->  enu
rahba  ->  enuon
rahn  ->  enua
rahna  ->  enuan
rahon  ->  enuba
rahs  ->  enuf
rahu  ->  enuh
rail  ->  envy
raine  ->  envar
rainen  ->  envara
rainer  ->  envare
rainera  ->  envaren
raj  ->  enw
ral  ->  eny
ralar  ->  enyne
ralben  ->  enyora
ralf  ->  enys
rali  ->  enyv
raliere  ->  enyvrer
ram  ->  enz
ramb  ->  enzo
ramn  ->  enza
ramna  ->  enzan
ran  ->  ena
rana  ->  enan
ranah  ->  enanu
ranc  ->  enap
rane  ->  enar
rang  ->  enat
rangr  ->  enate
rann  ->  enaa
ranon  ->  enaba
rany  ->  enal
ranz  ->  enam
raol  ->  enby
raon  ->  enba
rap  ->  enc
rapen  ->  encra
raper  ->  encre
rapere  ->  encrer
raphe  ->  encur
rapu  ->  ench
rapun  ->  encha
raq  ->  end
raqba  ->  endon
rar  ->  ene
rara  ->  enen
rare  ->  ener
rarer  ->  enere
rarf  ->  enes
ras  ->  enf
raserar  ->  enfrene
rasla  ->  enfyn
rasv  ->  enfi
rasva  ->  enfin
rasyn  ->  enfla
rat  ->  eng
rate  ->  engr
raten  ->  engra
ratene  ->  engrar
rath  ->  engu
rathe  ->  engur
ratla  ->  engyn
ratly  ->  engyl
ratna  ->  engan
ratnapura  ->  enganchen
ratre  ->  enger
ratu  ->  engh
rav  ->  eni
rava  ->  enin
ravan  ->  enina
ravier  ->  enivre
ravs  ->  enif
ravun  ->  eniha
raw  ->  enj
rawn  ->  enja
rax  ->  enk
ray  ->  enl
raz  ->  enm
razh  ->  enmu
razn  ->  enma
rb  ->  eo
rba  ->  eon
rbar  ->  eone
rbc  ->  eop
rbf  ->  eos
rbg  ->  eot
rbp  ->  eoc
rbq  ->  eod
rbs  ->  eof
rbt  ->  eog
rby  ->  eol
rc  ->  ep
rcaf  ->  epns
rcbp  ->  epoc
rcc  ->  epp
rcd  ->  epq
rce  ->  epr
rch  ->  epu
rcn  ->  epa
rcp  ->  epc
rct  ->  epg
rcu  ->  eph
rd  ->  eq
rdc  ->  eqp
rdf  ->  eqs
re  ->  er
're  ->  'er
rea  ->  ern
reaf  ->  erns
rean  ->  erna
reanne  ->  ernaar
rear  ->  erne
reard  ->  erneq
reave  ->  ernir
reb  ->  ero
reba  ->  eron
rebe  ->  eror
reboer  ->  erobre
reboere  ->  erobrer
rebore  ->  erober
rebri  ->  eroev
rebs  ->  erof
rec  ->  erp
recebo  ->  erprob
recs  ->  erpf
ree  ->  err
reeb  ->  erro
reef  ->  errs
reen  ->  erra
reenen  ->  errara
reer  ->  erre
reere  ->  errer
ref  ->  ers
refan  ->  ersna
refla  ->  ersyn
refr  ->  erse
refu  ->  ersh
reg  ->  ert
rege  ->  ertr
regen  ->  ertra
regent  ->  ertrag
regn  ->  erta
regna  ->  ertan
regnt  ->  ertag
regra  ->  erten
regrar  ->  ertene
regu  ->  erth
regula  ->  erthyn
regur  ->  erthe
reh  ->  eru
rehat  ->  erung
rehi  ->  eruv
rehne  ->  eruar
reho  ->  erub
rehv  ->  erui
rei  ->  erv
reif  ->  ervs
rein  ->  erva
reina  ->  ervan
reiner  ->  ervare
reir  ->  erve
reira  ->  erven
reiv  ->  ervi
reiva  ->  ervin
rej  ->  erw
rel  ->  ery
rele  ->  eryr
rely  ->  eryl
rem  ->  erz
remar  ->  erzne
remara  ->  erznen
remare  ->  erzner
ren  ->  era
rena  ->  eran
renan  ->  erana
renat  ->  erang
rener  ->  erare
reng  ->  erat
renin  ->  erava
renna  ->  eraan
rens  ->  eraf
rent  ->  erag
reny  ->  eral
renz  ->  eram
reo  ->  erb
reol  ->  erby
reon  ->  erba
reong  ->  erbat
reonz  ->  erbam
reor  ->  erbe
reorg  ->  erbet
rep  ->  erc
repu  ->  erch
repuna  ->  erchan
req  ->  erd
rer  ->  ere
rera  ->  eren
rere  ->  erer
res  ->  erf
resent  ->  erfrag
resh  ->  erfu
resla  ->  erfyn
resne  ->  erfar
resp  ->  erfc
resva  ->  erfin
ret  ->  erg
reten  ->  ergra
reter  ->  ergre
retn  ->  erga
retre  ->  erger
retu  ->  ergh
reuna  ->  erhan
rev  ->  eri
reva  ->  erin
revan  ->  erina
revar  ->  erine
revari  ->  erinev
revna  ->  erian
revy  ->  eril
revyr  ->  erile
revyy  ->  erill
rex  ->  erk
rexv  ->  erki
rey  ->  erl
reyn  ->  erla
reyna  ->  erlan
reyno  ->  erlab
reyr  ->  erle
reyv  ->  erli
reyve  ->  erlir
rez  ->  erm
reze  ->  ermr
rf  ->  es
rfa  ->  esn
rfb  ->  eso
rfc  ->  esp
rfd  ->  esq
rfe  ->  esr
rfes  ->  esrf
rfi  ->  esv
rfp  ->  esc
rfq  ->  esd
rfs  ->  esf
rft  ->  esg
rfv  ->  esi
rfx  ->  esk
rg  ->  et
rgb  ->  eto
rgs  ->  etf
rgy  ->  etl
rh  ->  eu
rha  ->  eun
rhag  ->  eunt
rhan  ->  euna
rhen  ->  eura
rhf  ->  eus
rhg  ->  eut
rhi  ->  euv
rhn  ->  eua
rhu  ->  euh
rhy  ->  eul
ri  ->  ev
ria  ->  evn
rian  ->  evna
riar  ->  evne
rib  ->  evo
riba  ->  evon
ribb  ->  evoo
ribe  ->  evor
riben  ->  evora
ribera  ->  evoren
ric  ->  evp
rieb  ->  evro
riehe  ->  evrur
riel  ->  evry
rien  ->  evra
riera  ->  evren
rif  ->  evs
rig  ->  evt
rih  ->  evu
riix  ->  evvk
ril  ->  evy
rily  ->  evyl
rin  ->  eva
rina  ->  evan
rinc  ->  evap
rine  ->  evar
ring  ->  evat
rink  ->  evax
rip  ->  evc
rir  ->  eve
rira  ->  even
rire  ->  ever
ris  ->  evf
riv  ->  evi
riva  ->  evin
rivan  ->  evina
rivar  ->  evine
riven  ->  evira
rivere  ->  evirer
riyr  ->  evle
riz  ->  evm
rj  ->  ew
rk  ->  ex
rkl  ->  exy
rl  ->  ey
rle  ->  eyr
rlr  ->  eye
rlv  ->  eyi
rm  ->  ez
rmb  ->  ezo
rmn  ->  eza
rmo  ->  ezb
rmu  ->  ezh
rn  ->  ea
rna  ->  ean
rnb  ->  eao
rnc  ->  eap
rne  ->  ear
rng  ->  eat
rni  ->  eav
rnn  ->  eaa
rnp  ->  eac
rnr  ->  eae
rns  ->  eaf
ro  ->  eb
roa  ->  ebn
roar  ->  ebne
roara  ->  ebnen
roare  ->  ebner
roba  ->  ebon
robal  ->  ebony
robe  ->  ebor
roben  ->  ebora
rober  ->  ebore
robi  ->  ebov
robo  ->  ebob
roby  ->  ebol
robyn  ->  ebola
rod  ->  ebq
roen  ->  ebra
roer  ->  ebre
rof  ->  ebs
roh  ->  ebu
rohe  ->  ebur
rohen  ->  ebura
rohl  ->  ebuy
roi  ->  ebv
roj  ->  ebw
rol  ->  eby
role  ->  ebyr
rolf  ->  ebys
ron  ->  eba
rona  ->  eban
roneo  ->  ebarb
roo  ->  ebb
roof  ->  ebbs
roog  ->  ebbt
rooj  ->  ebbw
roon  ->  ebba
roor  ->  ebbe
roov  ->  ebbi
ror  ->  ebe
rora  ->  eben
rorana  ->  ebenan
rorare  ->  ebener
rorarer  ->  ebenere
rorarere  ->  ebenerer
rore  ->  eber
rorer  ->  ebere
rory  ->  ebel
rov  ->  ebi
rova  ->  ebin
rovor  ->  ebibe
rox  ->  ebk
roy  ->  ebl
royna  ->  eblan
roz  ->  ebm
rp  ->  ec
rpc  ->  ecp
rpf  ->  ecs
rpg  ->  ect
rph  ->  ecu
rpk  ->  ecx
rpn  ->  eca
rpo  ->  ecb
rpp  ->  ecc
rpt  ->  ecg
rpv  ->  eci
rpzb  ->  ecmo
rqa  ->  edn
rqq  ->  edd
rr  ->  ee
rra  ->  een
rrag  ->  eent
rre  ->  eer
rref  ->  eers
rrey  ->  eerl
rrhh  ->  eeuu
rri  ->  eev
rrj  ->  eew
rrna  ->  eean
rrp  ->  eec
rrs  ->  eef
rrt  ->  eeg
rs  ->  ef
rsbe  ->  efor
rsc  ->  efp
rsf  ->  efs
rsg  ->  eft
rsh  ->  efu
rsi  ->  efv
rsn  ->  efa
rso  ->  efb
rss  ->  eff
rsv  ->  efi
rt  ->  eg
rta  ->  egn
rtb  ->  ego
rtc  ->  egp
rte  ->  egr
rtf  ->  egs
rtg  ->  egt
rtl  ->  egy
rtn  ->  ega
rtr  ->  ege
rtt  ->  egg
rtv  ->  egi
rty  ->  egl
ru  ->  eh
rub  ->  eho
ruba  ->  ehon
ruc  ->  ehp
ruch  ->  ehpu
rue  ->  ehr
rueg  ->  ehrt
ruer  ->  ehre
ruera  ->  ehren
ruf  ->  ehs
rug  ->  eht
rugar  ->  ehtne
rugr  ->  ehte
ruha  ->  ehun
rum  ->  ehz
run  ->  eha
runy  ->  ehal
rup  ->  ehc
rur  ->  ehe
rura  ->  ehen
rure  ->  eher
rurp  ->  ehec
ruu  ->  ehh
ruv  ->  ehi
ruvat  ->  ehing
ruve  ->  ehir
ruyn  ->  ehla
ruz  ->  ehm
rv  ->  ei
rva  ->  ein
rvan  ->  eina
rvb  ->  eio
rvf  ->  eis
rvh  ->  eiu
rvn  ->  eia
rvo  ->  eib
rvp  ->  eic
rvpv  ->  eici
rvv  ->  eii
rw  ->  ej
rwo  ->  ejb
rx  ->  ek
rxn  ->  eka
rxr  ->  eke
ry  ->  el
rya  ->  eln
ryan  ->  elna
ryb  ->  elo
ryba  ->  elon
rybar  ->  elone
ryc  ->  elp
rye  ->  elr
ryg  ->  elt
ryha  ->  elun
ryi  ->  elv
ryin  ->  elva
ryj  ->  elw
ryja  ->  elwn
ryk  ->  elx
ryl  ->  ely
ryla  ->  elyn
ryn  ->  ela
ryne  ->  elar
ryo  ->  elb
ryon  ->  elba
ryona  ->  elban
ryp  ->  elc
ryr  ->  ele
ryre  ->  eler
rys  ->  elf
ryse  ->  elfr
rysh  ->  elfu
ryt  ->  elg
ryte  ->  elgr
rytr  ->  elge
ryu  ->  elh
ryva  ->  elin
ryve  ->  elir
rz  ->  em
rza  ->  emn
rze  ->  emr
rzy  ->  eml
s  ->  f
s'  ->  f'
sa  ->  fn
saben  ->  fnora
sac  ->  fnp
sad  ->  fnq
saf  ->  fns
sah  ->  fnu
saht  ->  fnug
sai  ->  fnv
salf  ->  fnys
san  ->  fna
sane  ->  fnar
sanee  ->  fnarr
sans  ->  fnaf
sap  ->  fnc
saq  ->  fnd
sat  ->  fng
sb  ->  fo
sba  ->  fon
sban  ->  fona
sbar  ->  fone
sbc  ->  fop
sbe  ->  for
sbel  ->  fory
sber  ->  fore
sberla  ->  foreyn
sbf  ->  fos
sbh  ->  fou
sbi  ->  fov
sbir  ->  fove
sbj  ->  fow
sbk  ->  fox
sbm  ->  foz
sbn  ->  foa
sbog  ->  fobt
sbon  ->  foba
sbq  ->  fod
sbty  ->  fogl
sbu  ->  foh
sbx  ->  fok
sby  ->  fol
sc  ->  fp
sca  ->  fpn
scaf  ->  fpns
scb  ->  fpo
scf  ->  fps
sch  ->  fpu
sci  ->  fpv
scn  ->  fpa
sco  ->  fpb
scp  ->  fpc
scz  ->  fpm
sdg  ->  fqt
se  ->  fr
seb  ->  fro
seba  ->  fron
sebaq  ->  frond
sebax  ->  fronk
sebe  ->  fror
sebire  ->  frover
sebo  ->  frob
sebq  ->  frod
sebr  ->  froe
sebra  ->  froen
sebu  ->  froh
sec  ->  frp
sef  ->  frs
segn  ->  frta
seh  ->  fru
seha  ->  frun
sehn  ->  frua
sehne  ->  fruar
sehr  ->  frue
sehra  ->  fruen
seht  ->  frug
sejf  ->  frws
sel  ->  fry
self  ->  frys
selg  ->  fryt
selgu  ->  fryth
selr  ->  frye
sen  ->  fra
sena  ->  fran
senam  ->  franz
senan  ->  frana
senap  ->  franc
senar  ->  frane
senat  ->  frang
senatne  ->  frangar
sench  ->  frapu
send  ->  fraq
sene  ->  frar
sener  ->  frare
senf  ->  fras
seng  ->  frat
senger  ->  fratre
sengre  ->  frater
senh  ->  frau
senj  ->  fraw
senn  ->  fraa
senne  ->  fraar
seno  ->  frab
senp  ->  frac
sent  ->  frag
senten  ->  fragra
sentra  ->  fragen
senu  ->  frah
senvy  ->  frail
seny  ->  fral
senz  ->  fram
senzuri  ->  framhev
seo  ->  frb
sep  ->  frc
seq  ->  frd
ser  ->  fre
sera  ->  fren
seraf  ->  frens
serah  ->  frenu
seran  ->  frena
serang  ->  frenat
seraq  ->  frend
serar  ->  frene
serare  ->  frener
serarer  ->  frenere
serat  ->  freng
serb  ->  freo
serba  ->  freon
serbava  ->  freonin
serbe  ->  freor
serbu  ->  freoh
serd  ->  freq
sere  ->  frer
serer  ->  frere
serf  ->  fres
serg  ->  fret
sergh  ->  fretu
serk  ->  frex
serku  ->  frexh
serle  ->  freyr
serm  ->  frez
serna  ->  frean
seron  ->  freba
serp  ->  frec
serq  ->  fred
serr  ->  free
serra  ->  freen
serre  ->  freer
serrer  ->  freere
serry  ->  freel
serta  ->  fregn
sertar  ->  fregne
seru  ->  freh
serug  ->  freht
serv  ->  frei
serva  ->  frein
servar  ->  freine
servare  ->  freiner
servat  ->  freing
serve  ->  freir
serven  ->  freira
server  ->  freire
serzh  ->  fremu
ses  ->  frf
set  ->  frg
sev  ->  fri
seva  ->  frin
sevan  ->  frina
seve  ->  frir
sever  ->  frire
sevo  ->  frib
sevre  ->  frier
sevrer  ->  friere
sevrera  ->  frieren
sevyn  ->  frila
sew  ->  frj
sey  ->  frl
seyf  ->  frls
sf  ->  fs
sfa  ->  fsn
sfg  ->  fst
sfi  ->  fsv
sfo  ->  fsb
sfp  ->  fsc
sfs  ->  fsf
sfx  ->  fsk
sfz  ->  fsm
sg  ->  ft
sgb  ->  fto
sgc  ->  ftp
sge  ->  ftr
sgn  ->  fta
sgnn  ->  ftaa
sgp  ->  ftc
sgr  ->  fte
sh  ->  fu
sha  ->  fun
shaa  ->  funn
shaan  ->  funna
shab  ->  funo
shag  ->  funt
sham  ->  funz
shan  ->  funa
shana  ->  funan
shane  ->  funar
shaner  ->  funare
shang  ->  funat
shap  ->  func
shaq  ->  fund
shar  ->  fune
shara  ->  funen
sharer  ->  funere
sharm  ->  funez
shasha  ->  funfun
shat  ->  fung
shatner  ->  fungare
shatu  ->  fungh
shav  ->  funi
shava  ->  funin
shaw  ->  funj
shawn  ->  funja
shawna  ->  funjan
shba  ->  fuon
shbg  ->  fuot
shd  ->  fuq
she  ->  fur
shean  ->  furna
shear  ->  furne
sheare  ->  furner
sheave  ->  furnir
sheb  ->  furo
sheba  ->  furon
shebab  ->  furono
shebean  ->  furorna
shee  ->  furr
sheel  ->  furry
sheesh  ->  furrfu
shef  ->  furs
shehe  ->  furur
shem  ->  furz
shemb  ->  furzo
shen  ->  fura
shena  ->  furan
sheng  ->  furat
shenk  ->  furax
sheol  ->  furby
sher  ->  fure
shera  ->  furen
sherar  ->  furene
shere  ->  furer
sherer  ->  furere
sheu  ->  furh
sheva  ->  furin
shey  ->  furl
shf  ->  fus
shg  ->  fut
shih  ->  fuvu
shm  ->  fuz
shn  ->  fua
sho  ->  fub
shof  ->  fubs
shoh  ->  fubu
shone  ->  fubar
shool  ->  fubby
shp  ->  fuc
shra  ->  fuen
sht  ->  fug
shtf  ->  fugs
shtreb  ->  fugero
shtyr  ->  fugle
shu  ->  fuh
shue  ->  fuhr
shug  ->  fuht
shva  ->  fuin
shvt  ->  fuig
shy  ->  ful
shyn  ->  fula
shyne  ->  fular
shyt  ->  fulg
si  ->  fv
sieva  ->  fvrin
sij  ->  fvw
sis  ->  fvf
siu  ->  fvh
sj  ->  fw
sjf  ->  fws
sjn  ->  fwa
sjo  ->  fwb
sjs  ->  fwf
sju  ->  fwh
sjuf  ->  fwhs
sjw  ->  fwj
sk  ->  fx
sl  ->  fy
sla  ->  fyn
slag  ->  fynt
slater  ->  fyngre
sle  ->  fyr
slean  ->  fyrna
slee  ->  fyrr
sleer  ->  fyrre
slef  ->  fyrs
sleg  ->  fyrt
sleng  ->  fyrat
slev  ->  fyri
sleve  ->  fyrir
slg  ->  fyt
slir  ->  fyve
slpm  ->  fycz
slr  ->  fye
slrs  ->  fyef
sls  ->  fyf
slv  ->  fyi
sly  ->  fyl
slyna  ->  fylan
sm  ->  fz
sn  ->  fa
sna  ->  fan
snaar  ->  fanne
snab  ->  fano
snag  ->  fant
snaha  ->  fanun
snam  ->  fanz
snar  ->  fane
snara  ->  fanen
snare  ->  faner
snaren  ->  fanera
snarf  ->  fanes
snart  ->  faneg
snary  ->  fanel
snat  ->  fang
snath  ->  fangu
snau  ->  fanh
snb  ->  fao
sncf  ->  faps
snd  ->  faq
sne  ->  far
snea  ->  farn
sneb  ->  faro
snee  ->  farr
sneen  ->  farra
sneer  ->  farre
sneery  ->  farrel
sneg  ->  fart
snegl  ->  farty
sneh  ->  faru
snel  ->  fary
snen  ->  fara
sneng  ->  farat
sneo  ->  farb
sneon  ->  farba
sner  ->  fare
snerra  ->  fareen
snet  ->  farg
snf  ->  fas
snfr  ->  fase
sng  ->  fat
sngi  ->  fatv
sngr  ->  fate
sni  ->  fav
snib  ->  favo
snif  ->  favs
snin  ->  fava
sniv  ->  favi
snj  ->  faw
snl  ->  fay
snle  ->  fayr
snm  ->  faz
sno  ->  fab
snob  ->  fabo
snoba  ->  fabon
snobe  ->  fabor
snoer  ->  fabre
snof  ->  fabs
snon  ->  faba
snool  ->  fabby
snor  ->  fabe
snore  ->  faber
snorer  ->  fabere
snory  ->  fabel
snoryn  ->  fabela
snp  ->  fac
snq  ->  fad
snr  ->  fae
snrs  ->  faef
snt  ->  fag
sntl  ->  fagy
snu  ->  fah
snue  ->  fahr
snuf  ->  fahs
sny  ->  fal
snye  ->  falr
so  ->  fb
sob  ->  fbo
sod  ->  fbq
soe  ->  fbr
soef  ->  fbrs
sof  ->  fbs
soff  ->  fbss
sog  ->  fbt
soj  ->  fbw
sop  ->  fbc
sou  ->  fbh
sov  ->  fbi
sovre  ->  fbier
sp  ->  fc
spa  ->  fcn
spb  ->  fco
spc  ->  fcp
spen  ->  fcra
spf  ->  fcs
spg  ->  fct
sph  ->  fcu
spi  ->  fcv
spl  ->  fcy
spn  ->  fca
spo  ->  fcb
spof  ->  fcbs
spp  ->  fcc
spr  ->  fce
sps  ->  fcf
spz  ->  fcm
sq  ->  fd
sqd  ->  fdq
sqn  ->  fda
sqr  ->  fde
sqt  ->  fdg
sqv  ->  fdi
sr  ->  fe
sra  ->  fen
srab  ->  feno
srah  ->  fenu
srala  ->  fenyn
sraly  ->  fenyl
sram  ->  fenz
srana  ->  fenan
srane  ->  fenar
srap  ->  fenc
srath  ->  fengu
srb  ->  feo
src  ->  fep
sre  ->  fer
srea  ->  fern
sreba  ->  feron
sres  ->  ferf
srf  ->  fes
srh  ->  feu
sri  ->  fev
srian  ->  fevna
srj  ->  few
srk  ->  fex
srl  ->  fey
srm  ->  fez
srna  ->  fean
sro  ->  feb
srp  ->  fec
srqw  ->  fedj
srr  ->  fee
srt  ->  feg
srta  ->  fegn
sru  ->  feh
srv  ->  fei
srw  ->  fej
sry  ->  fel
ss  ->  ff
ssb  ->  ffo
ssbb  ->  ffoo
ssbns  ->  ffoaf
ssc  ->  ffp
sse  ->  ffr
ssef  ->  ffrs
ssf  ->  ffs
ssg  ->  fft
sshes  ->  ffurf
ssi  ->  ffv
ssl  ->  ffy
ssn  ->  ffa
sso  ->  ffb
sss  ->  fff
st  ->  fg
sta  ->  fgn
stf  ->  fgs
stl  ->  fgy
stp  ->  fgc
sts  ->  fgf
stv  ->  fgi
su  ->  fh
sub  ->  fho
sue  ->  fhr
suf  ->  fhs
sular  ->  fhyne
sum  ->  fhz
sun  ->  fha
suna  ->  fhan
sup  ->  fhc
suq  ->  fhd
sut  ->  fhg
suve  ->  fhir
suvs  ->  fhif
sv  ->  fi
sva  ->  fin
svaar  ->  finne
svaf  ->  fins
svag  ->  fint
svah  ->  finu
svan  ->  fina
svana  ->  finan
svane  ->  finar
svanen  ->  finara
svaner  ->  finare
svangr  ->  finate
svar  ->  fine
svara  ->  finen
svare  ->  finer
svarer  ->  finere
svarm  ->  finez
svarte  ->  finegr
svartna  ->  finegan
svarv  ->  finei
svat  ->  fing
svate  ->  fingr
svav  ->  fini
svc  ->  fip
sve  ->  fir
svea  ->  firn
sveg  ->  firt
sven  ->  fira
svena  ->  firan
svend  ->  firaq
sveni  ->  firav
sver  ->  fire
sverg  ->  firet
svev  ->  firi
sveva  ->  firin
sveve  ->  firir
svg  ->  fit
svi  ->  fiv
svin  ->  fiva
svir  ->  five
svire  ->  fiver
svk  ->  fix
svm  ->  fiz
svn  ->  fia
svo  ->  fib
svona  ->  fiban
svore  ->  fiber
svp  ->  fic
svq  ->  fid
svr  ->  fie
svrab  ->  fieno
svs  ->  fif
svt  ->  fig
svyn  ->  fila
svz  ->  fim
sw  ->  fj
swf  ->  fjs
swp  ->  fjc
sx  ->  fk
sxf  ->  fks
sy  ->  fl
sya  ->  fln
sybbe  ->  floor
sybo  ->  flob
syf  ->  fls
syg  ->  flt
syh  ->  flu
syha  ->  flun
syk  ->  flx
syl  ->  fly
syle  ->  flyr
sylf  ->  flys
syli  ->  flyv
sylla  ->  flyyn
sylt  ->  flyg
sylw  ->  flyj
syn  ->  fla
syna  ->  flan
synar  ->  flane
synat  ->  flang
sync  ->  flap
synene  ->  flarar
syner  ->  flare
synes  ->  flarf
synful  ->  flashy
syng  ->  flat
synge  ->  flatr
syngger  ->  flattre
syngr  ->  flate
syngvir  ->  flative
synir  ->  flave
synja  ->  flawn
synk  ->  flax
syno  ->  flab
synt  ->  flag
synth  ->  flagu
synu  ->  flah
syp  ->  flc
syr  ->  fle
syra  ->  flen
syrah  ->  flenu
syran  ->  flena
syrar  ->  flene
syre  ->  fler
syren  ->  flera
syrer  ->  flere
syrh  ->  fleu
syrk  ->  flex
syrnar  ->  fleane
syrra  ->  fleen
syrt  ->  fleg
syrx  ->  flek
syv  ->  fli
syve  ->  flir
syx  ->  flk
sz  ->  fm
sza  ->  fmn
sze  ->  fmr
szif  ->  fmvs
szw  ->  fmj
szy  ->  fml
t  ->  g
t'  ->  g'
t'a  ->  g'n
ta  ->  gn
taa  ->  gnn
tab  ->  gno
taba  ->  gnon
tabir  ->  gnove
tabs  ->  gnof
tabt  ->  gnog
tac  ->  gnp
tad  ->  gnq
taf  ->  gns
taff  ->  gnss
tah  ->  gnu
tahe  ->  gnur
taher  ->  gnure
tahra  ->  gnuen
tai  ->  gnv
taid  ->  gnvq
tan  ->  gna
tane  ->  gnar
tanen  ->  gnara
taner  ->  gnare
taney  ->  gnarl
tanf  ->  gnas
tang  ->  gnat
tanh  ->  gnau
tanin  ->  gnava
tanj  ->  gnaw
tanja  ->  gnawn
tann  ->  gnaa
tanpu  ->  gnach
tant  ->  gnag
tantan  ->  gnagna
tany  ->  gnal
tanz  ->  gnam
tao  ->  gnb
tap  ->  gnc
taq  ->  gnd
targ  ->  gnet
tari  ->  gnev
tarina  ->  gnevan
tart  ->  gneg
tarv  ->  gnei
tas  ->  gnf
tat  ->  gng
tau  ->  gnh
tav  ->  gni
tava  ->  gnin
tave  ->  gnir
tavi  ->  gniv
tavr  ->  gnie
tavy  ->  gnil
tay  ->  gnl
taz  ->  gnm
tb  ->  go
tba  ->  gon
tbbt  ->  goog
tbc  ->  gop
tbd  ->  goq
tbf  ->  gos
tbh  ->  gou
tbhq  ->  goud
tbi  ->  gov
tbk  ->  gox
tbl  ->  goy
tbm  ->  goz
tbmm  ->  gozz
tbn  ->  goa
tbp  ->  goc
tbq  ->  god
tbqh  ->  godu
tbr  ->  goe
tbs  ->  gof
tbt  ->  gog
tbu  ->  goh
tbx  ->  gok
tc  ->  gp
tcb  ->  gpo
tce  ->  gpr
tcf  ->  gps
tcg  ->  gpt
tch  ->  gpu
tcn  ->  gpa
tcp  ->  gpc
tcs  ->  gpf
td  ->  gq
te  ->  gr
tea  ->  grn
tean  ->  grna
teb  ->  gro
teba  ->  gron
tebaa  ->  gronn
tebal  ->  grony
teban  ->  grona
tebax  ->  gronk
tebbs  ->  groof
tebe  ->  gror
tebi  ->  grov
tebo  ->  grob
tebol  ->  groby
tebon  ->  groba
tebu  ->  groh
teby  ->  grol
tec  ->  grp
tee  ->  grr
teef  ->  grrs
teg  ->  grt
teh  ->  gru
teha  ->  grun
tehan  ->  gruna
tehina  ->  gruvan
teho  ->  grub
tehon  ->  gruba
tej  ->  grw
tek  ->  grx
tel  ->  gry
tela  ->  gryn
telaan  ->  grynna
telar  ->  gryne
tele  ->  gryr
teler  ->  gryre
telg  ->  gryt
tels  ->  gryf
ten  ->  gra
tena  ->  gran
tenang  ->  granat
tenar  ->  grane
tenarar  ->  granene
tenarna  ->  granean
tenava  ->  granin
tenavat  ->  graning
tenax  ->  grank
tenc  ->  grap
teng  ->  grat
tengu  ->  grath
tenh  ->  grau
tenha  ->  graun
teni  ->  grav
tenin  ->  grava
tenina  ->  gravan
tenir  ->  grave
tenk  ->  grax
tenla  ->  grayn
tenna  ->  graan
tenns  ->  graaf
tenny  ->  graal
teno  ->  grab
tenon  ->  graba
tenone  ->  grabar
tenoner  ->  grabare
tenoon  ->  grabba
tenor  ->  grabe
tenora  ->  graben
tenore  ->  graber
tenpu  ->  grach
tens  ->  graf
tensine  ->  grafvar
tent  ->  grag
tenta  ->  gragn
tenu  ->  grah
tenua  ->  grahn
tenun  ->  graha
tenur  ->  grahe
teny  ->  gral
tenze  ->  gramr
teo  ->  grb
teon  ->  grba
teor  ->  grbe
tep  ->  grc
ter  ->  gre
tera  ->  gren
terah  ->  grenu
teram  ->  grenz
teran  ->  grena
terang  ->  grenat
terar  ->  grene
terare  ->  grener
terat  ->  greng
terav  ->  greni
terc  ->  grep
terf  ->  gres
teri  ->  grev
terin  ->  greva
term  ->  grez
tern  ->  grea
terna  ->  grean
terne  ->  grear
terni  ->  greav
ternir  ->  greave
tero  ->  greb
teron  ->  greba
teror  ->  grebe
terp  ->  grec
terr  ->  gree
terra  ->  green
terral  ->  greeny
terrane  ->  greenar
terrar  ->  greene
terre  ->  greer
terrs  ->  greef
ters  ->  gref
tert  ->  greg
tertre  ->  greger
teru  ->  greh
terv  ->  grei
terva  ->  grein
tervan  ->  greina
tervy  ->  greil
tery  ->  grel
teryn  ->  grela
terz  ->  grem
tet  ->  grg
tetg  ->  grgt
teu  ->  grh
tev  ->  gri
teva  ->  grin
tevat  ->  gring
tevi  ->  griv
tevy  ->  gril
tewba  ->  grjon
tex  ->  grk
tey  ->  grl
teyr  ->  grle
tez  ->  grm
tf  ->  gs
tfb  ->  gso
tfc  ->  gsp
tfe  ->  gsr
tfn  ->  gsa
tfp  ->  gsc
tfr  ->  gse
tfs  ->  gsf
tft  ->  gsg
tg  ->  gt
tga  ->  gtn
tgd  ->  gtq
tge  ->  gtr
tgf  ->  gts
tgn  ->  gta
tgp  ->  gtc
tgv  ->  gti
tgy  ->  gtl
th  ->  gu
tha  ->  gun
thaa  ->  gunn
thaare  ->  gunner
thaba  ->  gunon
than  ->  guna
thapu  ->  gunch
thar  ->  gune
tharu  ->  guneh
that  ->  gung
thax  ->  gunk
thb  ->  guo
thc  ->  gup
the  ->  gur
thea  ->  gurn
thee  ->  gurr
theef  ->  gurrs
theel  ->  gurry
theen  ->  gurra
theer  ->  gurre
theg  ->  gurt
then  ->  gura
thena  ->  guran
theo  ->  gurb
ther  ->  gure
thera  ->  guren
they  ->  gurl
theyr  ->  gurle
thf  ->  gus
thg  ->  gut
thi  ->  guv
thj  ->  guw
thm  ->  guz
thng  ->  guat
tho  ->  gub
thoan  ->  gubna
thof  ->  gubs
thon  ->  guba
thonar  ->  gubane
thong  ->  gubat
thor  ->  gube
thore  ->  guber
thorp  ->  gubec
thr  ->  gue
thre  ->  guer
threel  ->  guerry
thronen  ->  guebara
ths  ->  guf
tht  ->  gug
thu  ->  guh
thune  ->  guhar
thv  ->  gui
thx  ->  guk
thy  ->  gul
thye  ->  gulr
thygh  ->  gultu
thyi  ->  gulv
thyn  ->  gula
thyne  ->  gular
thyng  ->  gulat
thyra  ->  gulen
thys  ->  gulf
thz  ->  gum
ti  ->  gv
tiana  ->  gvnan
tie  ->  gvr
tief  ->  gvrs
tiei  ->  gvrv
tif  ->  gvs
tih  ->  gvu
tij  ->  gvw
tin  ->  gva
tind  ->  gvaq
tiny  ->  gval
tiq  ->  gvd
tir  ->  gve
tiren  ->  gvera
tiv  ->  gvi
tivi  ->  gviv
tivy  ->  gvil
tizna  ->  gvman
tj  ->  gw
tja  ->  gwn
tjej  ->  gwrw
tjk  ->  gwx
tjo  ->  gwb
tjt  ->  gwg
tk  ->  gx
tl  ->  gy
tla  ->  gyn
tlb  ->  gyo
tlc  ->  gyp
tle  ->  gyr
tlen  ->  gyra
tli  ->  gyv
tlj  ->  gyw
tlm  ->  gyz
tln  ->  gya
tlr  ->  gye
tlv  ->  gyi
tm  ->  gz
tn  ->  ga
tna  ->  gan
tnaa  ->  gann
tnax  ->  gank
tnb  ->  gao
tnc  ->  gap
tne  ->  gar
tnef  ->  gars
tnejn  ->  garwa
tnel  ->  gary
tnf  ->  gas
tng  ->  gat
tni  ->  gav
tnie  ->  gavr
tnj  ->  gaw
tnl  ->  gay
tnln  ->  gaya
tnm  ->  gaz
tnn  ->  gaa
tno  ->  gab
tnou  ->  gabh
tnr  ->  gae
tns  ->  gaf
tnt  ->  gag
tnu  ->  gah
tnun  ->  gaha
tnw  ->  gaj
tnx  ->  gak
to  ->  gb
toa  ->  gbn
toc  ->  gbp
tod  ->  gbq
toe  ->  gbr
toen  ->  gbra
tof  ->  gbs
toh  ->  gbu
toi  ->  gbv
tok  ->  gbx
ton  ->  gba
tona  ->  gban
too  ->  gbb
top  ->  gbc
topf  ->  gbcs
tor  ->  gbe
tos  ->  gbf
tot  ->  gbg
tou  ->  gbh
tov  ->  gbi
tova  ->  gbin
toy  ->  gbl
toyr  ->  gble
tp  ->  gc
tpa  ->  gcn
tpc  ->  gcp
tpe  ->  gcr
tpf  ->  gcs
tpo  ->  gcb
tpp  ->  gcc
tpr  ->  gce
tps  ->  gcf
tpv  ->  gci
tq  ->  gd
tr  ->  ge
tra  ->  gen
traan  ->  genna
trab  ->  geno
traba  ->  genon
trabt  ->  genog
traer  ->  genre
traf  ->  gens
trag  ->  gent
tragare  ->  gentner
trahar  ->  genune
trahat  ->  genung
trahax  ->  genunk
traht  ->  genug
traire  ->  genver
tram  ->  genz
tran  ->  gena
tranc  ->  genap
trane  ->  genar
traner  ->  genare
trang  ->  genat
tranh  ->  genau
tranq  ->  genad
trap  ->  genc
trar  ->  gene
trarne  ->  genear
tras  ->  genf
trat  ->  geng
trate  ->  gengr
trath  ->  gengu
trav  ->  geni
trava  ->  genin
trax  ->  genk
trb  ->  geo
trc  ->  gep
trd  ->  geq
tre  ->  ger
trea  ->  gern
treb  ->  gero
treba  ->  geron
tree  ->  gerr
treen  ->  gerra
tref  ->  gers
trefu  ->  gersh
treg  ->  gert
treiv  ->  gervi
tren  ->  gera
trenava  ->  geranin
trene  ->  gerar
trenen  ->  gerara
trener  ->  gerare
treng  ->  gerat
trenin  ->  gerava
trens  ->  geraf
trenu  ->  gerah
treny  ->  geral
treo  ->  gerb
treor  ->  gerbe
trer  ->  gere
treun  ->  gerha
trev  ->  geri
treva  ->  gerin
treven  ->  gerira
treyn  ->  gerla
trez  ->  germ
trf  ->  ges
trg  ->  get
trgb  ->  geto
trh  ->  geu
trhat  ->  geung
tri  ->  gev
trien  ->  gevra
trin  ->  geva
trina  ->  gevan
tring  ->  gevat
trir  ->  geve
trive  ->  gevir
triven  ->  gevira
trivere  ->  gevirer
trje  ->  gewr
trl  ->  gey
trn  ->  gea
trna  ->  gean
trnava  ->  geanin
tro  ->  geb
troene  ->  gebrar
troer  ->  gebre
trof  ->  gebs
trog  ->  gebt
troha  ->  gebun
trole  ->  gebyr
tron  ->  geba
trona  ->  geban
trone  ->  gebar
troner  ->  gebare
tronera  ->  gebaren
trong  ->  gebat
tronne  ->  gebaar
tror  ->  gebe
trorog  ->  gebebt
trp  ->  gec
trs  ->  gef
trt  ->  geg
tru  ->  geh
trua  ->  gehn
trub  ->  geho
truba  ->  gehon
true  ->  gehr
trug  ->  geht
trun  ->  geha
truna  ->  gehan
trung  ->  gehat
trur  ->  gehe
truve  ->  gehir
truy  ->  gehl
trv  ->  gei
try  ->  gel
tryb  ->  gelo
tryba  ->  gelon
trybe  ->  gelor
tryer  ->  gelre
tryg  ->  gelt
trygve  ->  geltir
tryn  ->  gela
tryna  ->  gelan
tryne  ->  gelar
trynen  ->  gelara
tryner  ->  gelare
tryt  ->  gelg
trzon  ->  gemba
ts  ->  gf
tsb  ->  gfo
tsc  ->  gfp
tse  ->  gfr
tsf  ->  gfs
tsh  ->  gfu
tsk  ->  gfx
tsl  ->  gfy
tsp  ->  gfc
tsps  ->  gfcf
tsr  ->  gfe
tsv  ->  gfi
tt  ->  gg
ttg  ->  ggt
ttl  ->  ggy
ttr  ->  gge
ttt  ->  ggg
tty  ->  ggl
tu  ->  gh
tub  ->  gho
tubat  ->  ghong
tube  ->  ghor
tuben  ->  ghora
tubez  ->  ghorm
tubo  ->  ghob
tud  ->  ghq
tuf  ->  ghs
tuh  ->  ghu
tuhon  ->  ghuba
tum  ->  ghz
tun  ->  gha
tuna  ->  ghan
tunan  ->  ghana
tune  ->  ghar
tunee  ->  gharr
tunen  ->  ghara
tung  ->  ghat
tunla  ->  ghayn
tunn  ->  ghaa
tunna  ->  ghaan
tunou  ->  ghabh
tunten  ->  ghagra
tuny  ->  ghal
tuo  ->  ghb
tur  ->  ghe
tura  ->  ghen
turar  ->  ghene
turbetur  ->  gheorghe
tureen  ->  gherra
turen  ->  ghera
turer  ->  ghere
turnee  ->  ghearr
turner  ->  gheare
turo  ->  gheb
turov  ->  ghebi
turr  ->  ghee
turra  ->  gheen
turt  ->  gheg
turtur  ->  gheghe
turvou  ->  gheibh
tut  ->  ghg
tuv  ->  ghi
tuva  ->  ghin
tuvar  ->  ghine
tuvu  ->  ghih
tv  ->  gi
tva  ->  gin
tvang  ->  ginat
tvar  ->  gine
tvara  ->  ginen
tvarer  ->  ginere
tvb  ->  gio
tvc  ->  gip
tvcr  ->  gipe
tve  ->  gir
tver  ->  gire
tvey  ->  girl
tvg  ->  git
tvh  ->  giu
tvi  ->  giv
tvnz  ->  giam
tvo  ->  gib
tvor  ->  gibe
tvora  ->  giben
tvore  ->  giber
tvory  ->  gibel
tvp  ->  gic
tvq  ->  gid
tvr  ->  gie
tvs  ->  gif
tvtb  ->  gigo
tvw  ->  gij
tw  ->  gj
twb  ->  gjo
twng  ->  gjat
twr  ->  gje
twrw  ->  gjej
tx  ->  gk
txn  ->  gka
ty  ->  gl
tya  ->  gln
tyb  ->  glo
tyber  ->  glore
tyht  ->  glug
tyk  ->  glx
tyl  ->  gly
tyla  ->  glyn
tylo  ->  glyb
tyn  ->  gla
tynan  ->  glana
tynans  ->  glanaf
tyne  ->  glar
tyner  ->  glare
tyng  ->  glat
tynin  ->  glava
tyning  ->  glavat
tynner  ->  glaare
tyo  ->  glb
typ  ->  glc
tyr  ->  gle
tyra  ->  glen
tyran  ->  glena
tyre  ->  gler
tyren  ->  glera
tyrf  ->  gles
tyrin  ->  gleva
tyrnir  ->  gleave
tyro  ->  gleb
tyrol  ->  gleby
tyron  ->  gleba
tyt  ->  glg
tyv  ->  gli
tyva  ->  glin
tyve  ->  glir
tyver  ->  glire
tyvs  ->  glif
tz  ->  gm
tza  ->  gmn
tzo  ->  gmb
tzs  ->  gmf
u  ->  h
u'  ->  h'
ua  ->  hn
uab  ->  hno
uac  ->  hnp
uah  ->  hnu
uahi  ->  hnuv
ual  ->  hny
uan  ->  hna
uang  ->  hnat
uap  ->  hnc
uaq  ->  hnd
uar  ->  hne
uat  ->  hng
uav  ->  hni
ub  ->  ho
uba  ->  hon
ubag  ->  hont
ubah  ->  honu
ubal  ->  hony
uban  ->  hona
ubar  ->  hone
ubara  ->  honen
ubare  ->  honer
ubat  ->  hong
ubax  ->  honk
ubb  ->  hoo
ubba  ->  hoon
ubc  ->  hop
ubcs  ->  hopf
ube  ->  hor
ubeh  ->  horu
uber  ->  hore
ubera  ->  horen
ubere  ->  horer
uberer  ->  horere
uberere  ->  horerer
ubh  ->  hou
ubha  ->  houn
ubi  ->  hov
ubil  ->  hovy
ubn  ->  hoa
ubo  ->  hob
ubog  ->  hobt
ubora  ->  hoben
ubp  ->  hoc
ubq  ->  hod
ubre  ->  hoer
ubrir  ->  hoeve
ubs  ->  hof
ubt  ->  hog
ubu  ->  hoh
ubur  ->  hohe
ubyx  ->  holk
uc  ->  hp
uce  ->  hpr
uci  ->  hpv
ucl  ->  hpy
ucp  ->  hpc
ucs  ->  hpf
ucu  ->  hph
ud  ->  hq
udc  ->  hqp
udf  ->  hqs
udp  ->  hqc
udy  ->  hql
ue  ->  hr
ueh  ->  hru
uei  ->  hrv
uel  ->  hry
ueno  ->  hrab
uer  ->  hre
uera  ->  hren
uero  ->  hreb
uf  ->  hs
ufa  ->  hsn
ufc  ->  hsp
uff  ->  hss
ufi  ->  hsv
ufs  ->  hsf
ufu  ->  hsh
ufy  ->  hsl
ug  ->  ht
ugc  ->  htp
uge  ->  htr
ugh  ->  htu
ugs  ->  htf
ugt  ->  htg
ugu  ->  hth
uh  ->  hu
uha  ->  hun
uhan  ->  huna
uhart  ->  huneg
uhat  ->  hung
uhc  ->  hup
uhd  ->  huq
uhe  ->  hur
uhel  ->  hury
uher  ->  hure
uhf  ->  hus
uhh  ->  huu
uhi  ->  huv
uhin  ->  huva
uhl  ->  huy
uhler  ->  huyre
uhm  ->  huz
uho  ->  hub
uhol  ->  huby
uhon  ->  huba
uhor  ->  hube
uhp  ->  huc
uhr  ->  hue
uhre  ->  huer
uhren  ->  huera
uhrin  ->  hueva
uhry  ->  huel
uhs  ->  huf
uht  ->  hug
uhu  ->  huh
uhuh  ->  huhu
uhv  ->  hui
uhw  ->  huj
uhyra  ->  hulen
uhyre  ->  huler
uhz  ->  hum
ui  ->  hv
uib  ->  hvo
uin  ->  hva
uine  ->  hvar
uinge  ->  hvatr
uiva  ->  hvin
uj  ->  hw
uja  ->  hwn
ujna  ->  hwan
ujo  ->  hwb
uk  ->  hx
ukp  ->  hxc
ul  ->  hy
ula  ->  hyn
ulaf  ->  hyns
ulag  ->  hynt
ulans  ->  hynaf
ular  ->  hyne
ulc  ->  hyp
ule  ->  hyr
ulee  ->  hyrr
uleg  ->  hyrt
ulen  ->  hyra
uler  ->  hyre
ulf  ->  hys
ulfr  ->  hyse
ulg  ->  hyt
uli  ->  hyv
ulin  ->  hyva
ulire  ->  hyver
uliva  ->  hyvin
ulj  ->  hyw
ull  ->  hyy
ullel  ->  hyyry
ulm  ->  hyz
uln  ->  hya
ulnar  ->  hyane
ulne  ->  hyar
ulp  ->  hyc
uls  ->  hyf
ulten  ->  hygra
ultu  ->  hygh
ulture  ->  hygher
ulu  ->  hyh
ulv  ->  hyi
um  ->  hz
umet  ->  hzrg
un  ->  ha
un'  ->  ha'
'un  ->  'ha
una  ->  han
unal  ->  hany
unan  ->  hana
unaone  ->  hanbar
unarc  ->  hanep
unary  ->  hanel
unas  ->  hanf
unat  ->  hang
unb  ->  hao
unc  ->  hap
uncare  ->  hapner
uncf  ->  haps
unch  ->  hapu
und  ->  haq
une  ->  har
unecha  ->  harpun
unei  ->  harv
unem  ->  harz
unen  ->  hara
unena  ->  haran
unene  ->  harar
unep  ->  harc
unes  ->  harf
uneun  ->  harha
uneven  ->  harira
unf  ->  has
unfry  ->  hasel
ung  ->  hat
ungan  ->  hatna
unge  ->  hatr
ungen  ->  hatra
ungern  ->  hatrea
ungh  ->  hatu
ungla  ->  hatyn
ungle  ->  hatyr
ungr  ->  hate
ungra  ->  haten
ungu  ->  hath
ungur  ->  hathe
unh  ->  hau
unha  ->  haun
unhat  ->  haung
unhe  ->  haur
unhear  ->  haurne
unhewn  ->  haurja
unho  ->  haub
uni  ->  hav
unia  ->  havn
uniar  ->  havne
uniare  ->  havner
unie  ->  havr
unien  ->  havra
uniera  ->  havren
unig  ->  havt
uniin  ->  havva
unin  ->  hava
unina  ->  havan
uning  ->  havat
unir  ->  have
unira  ->  haven
unire  ->  haver
unirer  ->  havere
univ  ->  havi
univen  ->  havira
unix  ->  havk
unj  ->  haw
unja  ->  hawn
unk  ->  hax
unkna  ->  haxan
unlar  ->  hayne
unlv  ->  hayi
unman  ->  hazna
unmr  ->  haze
unn  ->  haa
unna  ->  haan
unnar  ->  haane
unne  ->  haar
unnen  ->  haara
unner  ->  haare
unni  ->  haav
unno  ->  haab
unns  ->  haaf
unnt  ->  haag
uno  ->  hab
unob  ->  habo
unor  ->  habe
unora  ->  haben
unp  ->  hac
unpure  ->  hacher
unq  ->  had
unra  ->  haen
uns  ->  haf
unsa  ->  hafn
unsane  ->  hafnar
unse  ->  hafr
unsene  ->  hafrar
unser  ->  hafre
unsin  ->  hafva
unsre  ->  hafer
unt  ->  hag
untan  ->  hagna
untare  ->  hagner
unte  ->  hagr
untere  ->  hagrer
unterer  ->  hagrere
unthat  ->  hagung
unty  ->  hagl
unu  ->  hah
unua  ->  hahn
unul  ->  hahy
unun  ->  haha
unur  ->  hahe
unura  ->  hahen
unva  ->  hain
unvan  ->  haina
unwon  ->  hajba
unyi  ->  halv
unyon  ->  halba
unz  ->  ham
unza  ->  hamn
unzan  ->  hamna
unze  ->  hamr
unzen  ->  hamra
uo  ->  hb
uod  ->  hbq
uog  ->  hbt
uol  ->  hby
uon  ->  hba
uop  ->  hbc
uos  ->  hbf
up  ->  hc
upa  ->  hcn
upb  ->  hco
upc  ->  hcp
upe  ->  hcr
upf  ->  hcs
upi  ->  hcv
upn  ->  hca
ups  ->  hcf
upv  ->  hci
uq  ->  hd
uqi  ->  hdv
ur  ->  he
ura  ->  hen
uraa  ->  henn
uraan  ->  henna
urag  ->  hent
urahn  ->  henua
uran  ->  hena
urana  ->  henan
urane  ->  henar
urar  ->  hene
urat  ->  heng
urb  ->  heo
urba  ->  heon
urbana  ->  heonan
urbe  ->  heor
urbs  ->  heof
urc  ->  hep
urcare  ->  hepner
urch  ->  hepu
urd  ->  heq
ure  ->  her
urea  ->  hern
urean  ->  herna
urebare  ->  heroner
uree  ->  herr
urefu  ->  hersh
urei  ->  herv
uren  ->  hera
urena  ->  heran
urene  ->  herar
ureno  ->  herab
ureo  ->  herb
urer  ->  here
urerer  ->  herere
urerere  ->  hererer
urerne  ->  herear
ures  ->  herf
urey  ->  herl
urez  ->  herm
urf  ->  hes
urg  ->  het
urgh  ->  hetu
urgira  ->  hetven
urgu  ->  heth
uri  ->  hev
uria  ->  hevn
uriba  ->  hevon
urin  ->  heva
urina  ->  hevan
uriq  ->  hevd
urira  ->  heven
urja  ->  hewn
urk  ->  hex
url  ->  hey
urla  ->  heyn
urlar  ->  heyne
urli  ->  heyv
urls  ->  heyf
urm  ->  hez
urn  ->  hea
urna  ->  hean
urne  ->  hear
urner  ->  heare
urns  ->  heaf
uro  ->  heb
uroen  ->  hebra
uron  ->  heba
uroon  ->  hebba
uror  ->  hebe
urp  ->  hec
urpu  ->  hech
urqu  ->  hedh
urr  ->  hee
urra  ->  heen
urre  ->  heer
urrea  ->  heern
urro  ->  heeb
urry  ->  heel
urs  ->  hef
ursan  ->  hefna
urt  ->  heg
urta  ->  hegn
urtan  ->  hegna
urtene  ->  hegrar
urter  ->  hegre
uru  ->  heh
urub  ->  heho
urue  ->  hehr
urug  ->  heht
urva  ->  hein
urval  ->  heiny
urve  ->  heir
urvne  ->  heiar
ury  ->  hel
urzo  ->  hemb
us  ->  hf
usa  ->  hfn
use  ->  hfr
users  ->  hfref
usi  ->  hfv
usn  ->  hfa
usp  ->  hfc
ut  ->  hg
utc  ->  hgp
utf  ->  hgs
utg  ->  hgt
uti  ->  hgv
uto  ->  hgb
utu  ->  hgh
uu  ->  hh
uum  ->  hhz
uur  ->  hhe
uv  ->  hi
uva  ->  hin
uvam  ->  hinz
uvan  ->  hina
uvar  ->  hine
uvars  ->  hinef
uve  ->  hir
uvea  ->  hirn
uvee  ->  hirr
uven  ->  hira
uver  ->  hire
uvera  ->  hiren
uvf  ->  his
uvi  ->  hiv
uvo  ->  hib
uvor  ->  hibe
uvre  ->  hier
uvrir  ->  hieve
uvro  ->  hieb
uvs  ->  hif
uvve  ->  hiir
uw  ->  hj
uwb  ->  hjo
uwo  ->  hjb
ux  ->  hk
uy  ->  hl
uyni  ->  hlav
uyog  ->  hlbt
uz  ->  hm
uzb  ->  hmo
uzh  ->  hmu
uzi  ->  hmv
uzs  ->  hmf
uzu  ->  hmh
uzyn  ->  hmla
v  ->  i
v'  ->  i'
va  ->  in
vaa  ->  inn
vaal  ->  inny
vaan  ->  inna
vaane  ->  innar
vaar  ->  inne
vaara  ->  innen
vab  ->  ino
vaba  ->  inon
vabeh  ->  inoru
vacher  ->  inpure
vae  ->  inr
vaf  ->  ins
vaff  ->  inss
vafre  ->  inser
vag  ->  int
vage  ->  intr
vagen  ->  intra
vager  ->  intre
vagere  ->  intrer
vagerer  ->  intrere
vaghn  ->  intua
vagl  ->  inty
vagn  ->  inta
vagna  ->  intan
vagun  ->  intha
vagy  ->  intl
vah  ->  inu
vahaa  ->  inunn
vahana  ->  inunan
vahat  ->  inung
vaher  ->  inure
vahn  ->  inua
vaht  ->  inug
vahv  ->  inui
vai  ->  inv
vain  ->  inva
vaine  ->  invar
vaire  ->  inver
vakn  ->  inxa
val  ->  iny
van  ->  ina
vana  ->  inan
vanan  ->  inana
vanar  ->  inane
vanare  ->  inaner
vanat  ->  inang
vanc  ->  inap
vane  ->  inar
vanen  ->  inara
vang  ->  inat
vangr  ->  inate
vanh  ->  inau
vanhan  ->  inauna
vani  ->  inav
vanl  ->  inay
vanth  ->  inagu
vanu  ->  inah
vanun  ->  inaha
vanuva  ->  inahin
vany  ->  inal
vap  ->  inc
vapna  ->  incan
vapula  ->  inchyn
vapun  ->  incha
vapur  ->  inche
vaq  ->  ind
var  ->  ine
vara  ->  inen
varal  ->  ineny
varar  ->  inene
varat  ->  ineng
varb  ->  ineo
varbe  ->  ineor
vare  ->  iner
varer  ->  inere
varg  ->  inet
vark  ->  inex
varm  ->  inez
varne  ->  inear
varner  ->  ineare
varo  ->  ineb
varr  ->  inee
varra  ->  ineen
varv  ->  inei
vary  ->  inel
vas  ->  inf
vasen  ->  infra
vaser  ->  infre
vat  ->  ing
vatar  ->  ingne
vath  ->  ingu
vatn  ->  inga
vatna  ->  ingan
vatnat  ->  ingang
vatne  ->  ingar
vatns  ->  ingaf
vatra  ->  ingen
vatren  ->  ingera
vau  ->  inh
vaut  ->  inhg
vav  ->  ini
vava  ->  inin
vavat  ->  ining
vavon  ->  iniba
vavv  ->  inii
vaw  ->  inj
vawr  ->  inje
vax  ->  ink
vaz  ->  inm
vazba  ->  inmon
vb  ->  io
vba  ->  ion
vbba  ->  ioon
vbr  ->  ioe
vbs  ->  iof
vbv  ->  ioi
vc  ->  ip
vcb  ->  ipo
vcbs  ->  ipof
vcc  ->  ipp
vcl  ->  ipy
vcp  ->  ipc
vcr  ->  ipe
vcs  ->  ipf
vd  ->  iq
ve  ->  ir
vea  ->  irn
vear  ->  irne
vec  ->  irp
vecs  ->  irpf
ved  ->  irq
vedy  ->  irql
vee  ->  irr
veeg  ->  irrt
veen  ->  irra
veer  ->  irre
veera  ->  irren
veere  ->  irrer
vef  ->  irs
vefr  ->  irse
veg  ->  irt
vegf  ->  irts
vegn  ->  irta
vegr  ->  irte
vegra  ->  irten
vegur  ->  irthe
vehat  ->  irung
vehe  ->  irur
vei  ->  irv
veir  ->  irve
veira  ->  irven
veiv  ->  irvi
veiva  ->  irvin
vel  ->  iry
ven  ->  ira
vena  ->  iran
venane  ->  iranar
venar  ->  irane
venare  ->  iraner
venarer  ->  iranere
venc  ->  irap
vend  ->  iraq
vene  ->  irar
venen  ->  irara
veng  ->  irat
venha  ->  iraun
venin  ->  irava
venna  ->  iraan
venon  ->  iraba
venz  ->  iram
veo  ->  irb
vep  ->  irc
vepre  ->  ircer
ver  ->  ire
vera  ->  iren
veran  ->  irena
verar  ->  irene
verat  ->  ireng
vere  ->  irer
verer  ->  irere
verf  ->  ires
verg  ->  iret
verghe  ->  iretur
verm  ->  irez
veron  ->  ireba
verr  ->  iree
verv  ->  irei
verz  ->  irem
ves  ->  irf
vesna  ->  irfan
vet  ->  irg
veth  ->  irgu
vety  ->  irgl
vev  ->  iri
veva  ->  irin
vevar  ->  irine
vevat  ->  iring
vevd  ->  iriq
veve  ->  irir
vex  ->  irk
vey  ->  irl
vez  ->  irm
vf  ->  is
vfb  ->  iso
vfl  ->  isy
vfm  ->  isz
vfr  ->  ise
vfrs  ->  isef
vfs  ->  isf
vfx  ->  isk
vg  ->  it
vga  ->  itn
vgb  ->  ito
vgc  ->  itp
vgi  ->  itv
vgn  ->  ita
vgs  ->  itf
vh  ->  iu
vhb  ->  iuo
vhf  ->  ius
vhp  ->  iuc
vi  ->  iv
vib  ->  ivo
vibe  ->  ivor
vie  ->  ivr
vief  ->  ivrs
viel  ->  ivry
vier  ->  ivre
viern  ->  ivrea
vif  ->  ivs
vig  ->  ivt
vigu  ->  ivth
vih  ->  ivu
vihm  ->  ivuz
vil  ->  ivy
vin  ->  iva
vina  ->  ivan
vinan  ->  ivana
vine  ->  ivar
vinf  ->  ivas
ving  ->  ivat
vinn  ->  ivaa
vinna  ->  ivaan
vinning  ->  ivaavat
vio  ->  ivb
vip  ->  ivc
vir  ->  ive
vire  ->  iver
virera  ->  iveren
virl  ->  ivey
viry  ->  ivel
vis  ->  ivf
vit  ->  ivg
vitha  ->  ivgun
viv  ->  ivi
viva  ->  ivin
vivre  ->  ivier
vivy  ->  ivil
viz  ->  ivm
vj  ->  iw
vjs  ->  iwf
vk  ->  ix
vkh  ->  ixu
vki  ->  ixv
vl  ->  iy
vlak  ->  iynx
vlat  ->  iyng
vlh  ->  iyu
vlha  ->  iyun
vlna  ->  iyan
vm  ->  iz
vmd  ->  izq
vme  ->  izr
vmm  ->  izz
vmr  ->  ize
vn  ->  ia
vnar  ->  iane
vnc  ->  iap
vnch  ->  iapu
vnd  ->  iaq
vne  ->  iar
vnm  ->  iaz
vnns  ->  iaaf
vns  ->  iaf
vo  ->  ib
voa  ->  ibn
voaba  ->  ibnon
voan  ->  ibna
voar  ->  ibne
vob  ->  ibo
voe  ->  ibr
vof  ->  ibs
vogn  ->  ibta
voh  ->  ibu
von  ->  iba
vona  ->  iban
vone  ->  ibar
voner  ->  ibare
vong  ->  ibat
vont  ->  ibag
vonz  ->  ibam
voo  ->  ibb
vop  ->  ibc
vor  ->  ibe
vora  ->  iben
vore  ->  iber
voren  ->  ibera
vorene  ->  iberar
vorer  ->  ibere
vorera  ->  iberen
vorere  ->  iberer
vork  ->  ibex
vory  ->  ibel
vos  ->  ibf
vou  ->  ibh
vov  ->  ibi
voven  ->  ibira
voz  ->  ibm
voze  ->  ibmr
vozna  ->  ibman
vp  ->  ic
vpa  ->  icn
vpc  ->  icp
vpd  ->  icq
vpg  ->  ict
vpl  ->  icy
vpn  ->  ica
vps  ->  icf
vr  ->  ie
vra  ->  ien
vraf  ->  iens
vran  ->  iena
vrb  ->  ieo
vre  ->  ier
vreg  ->  iert
vrer  ->  iere
vrg  ->  iet
vrh  ->  ieu
vri  ->  iev
vrin  ->  ieva
vro  ->  ieb
vrp  ->  iec
vrs  ->  ief
vrt  ->  ieg
vry  ->  iel
vryf  ->  iels
vs  ->  if
vsb  ->  ifo
vse  ->  ifr
vsf  ->  ifs
vsi  ->  ifv
vsp  ->  ifc
vss  ->  iff
vsv  ->  ifi
vt  ->  ig
vta  ->  ign
vth  ->  igu
vtr  ->  ige
vts  ->  igf
vtt  ->  igg
vu  ->  ih
vua  ->  ihn
vue  ->  ihr
vuere  ->  ihrer
vuf  ->  ihs
vug  ->  iht
vuh  ->  ihu
vui  ->  ihv
vun  ->  iha
vuna  ->  ihan
vung  ->  ihat
vuo  ->  ihb
vur  ->  ihe
vuren  ->  ihera
vuv  ->  ihi
vuz  ->  ihm
vv  ->  ii
vva  ->  iin
vvk  ->  iix
vvu  ->  iih
vw  ->  ij
vwa  ->  ijn
vwf  ->  ijs
vx  ->  ik
vxen  ->  ikra
vxer  ->  ikre
vy  ->  il
vye  ->  ilr
vyf  ->  ils
vygn  ->  ilta
vyn  ->  ila
vyne  ->  ilar
vyner  ->  ilare
vyny  ->  ilal
vyre  ->  iler
vyv  ->  ili
vz  ->  im
vzav  ->  imni
vzor  ->  imbe
vzv  ->  imi
w  ->  j
wa  ->  jn
waa  ->  jnn
wab  ->  jno
wabi  ->  jnov
wad  ->  jnq
wae  ->  jnr
waf  ->  jns
wag  ->  jnt
wags  ->  jntf
wah  ->  jnu
waj  ->  jnw
wan  ->  jna
wanan  ->  jnana
wao  ->  jnb
war  ->  jne
wat  ->  jng
waw  ->  jnj
wax  ->  jnk
waz  ->  jnm
wb  ->  jo
wba  ->  jon
wbd  ->  joq
wbe  ->  jor
wbf  ->  jos
wbn  ->  joa
wbo  ->  job
wbu  ->  joh
wbw  ->  joj
wc  ->  jp
wca  ->  jpn
wcf  ->  jps
wcg  ->  jpt
wcs  ->  jpf
we  ->  jr
wec  ->  jrp
weg  ->  jrt
wej  ->  jrw
wel  ->  jry
wen  ->  jra
weni  ->  jrav
wer  ->  jre
werf  ->  jres
wers  ->  jref
wet  ->  jrg
wf  ->  js
wfc  ->  jsp
wfh  ->  jsu
wfj  ->  jsw
wfk  ->  jsx
wfl  ->  jsy
wfp  ->  jsc
wg  ->  jt
wga  ->  jtn
wha  ->  jun
whal  ->  juny
whan  ->  juna
whana  ->  junan
whang  ->  junat
whap  ->  junc
whar  ->  june
whare  ->  juner
wharf  ->  junes
what  ->  jung
whath  ->  jungu
whatu  ->  jungh
whau  ->  junh
whe  ->  jur
wheal  ->  jurny
wheel  ->  jurry
whel  ->  jury
when  ->  jura
wher  ->  jure
where  ->  jurer
wherf  ->  jures
whil  ->  juvy
whin  ->  juva
whinen  ->  juvara
whiner  ->  juvare
whing  ->  juvat
whir  ->  juve
whirl  ->  juvey
whm  ->  juz
whon  ->  juba
whone  ->  jubar
whoo  ->  jubb
whoore  ->  jubber
whq  ->  jud
whr  ->  jue
whs  ->  juf
wht  ->  jug
whur  ->  juhe
why  ->  jul
whyn  ->  jula
whyne  ->  jular
wi  ->  jv
wic  ->  jvp
wif  ->  jvs
win  ->  jva
wio  ->  jvb
wip  ->  jvc
wiz  ->  jvm
wj  ->  jw
wk  ->  jx
wl  ->  jy
wla  ->  jyn
wlak  ->  jynx
wm  ->  jz
wn  ->  ja
wn'  ->  ja'
wna  ->  jan
wnb  ->  jao
wnba  ->  jaon
wnc  ->  jap
wnd  ->  jaq
wnei  ->  jarv
wnet  ->  jarg
wng  ->  jat
wnj  ->  jaw
wnl  ->  jay
wnm  ->  jaz
wnmj  ->  jazw
wnn  ->  jaa
wnne  ->  jaar
wnnt  ->  jaag
wns  ->  jaf
wnt  ->  jag
wnu  ->  jah
wnw  ->  jaj
wnwn  ->  jaja
wo  ->  jb
woa  ->  jbn
wob  ->  jbo
woe  ->  jbr
wog  ->  jbt
wol  ->  jby
woq  ->  jbd
wow  ->  jbj
wp  ->  jc
wpc  ->  jcp
wpg  ->  jct
wr  ->  je
wra  ->  jen
wraaf  ->  jenns
wraf  ->  jens
wrana  ->  jenan
wrang  ->  jenat
wrat  ->  jeng
wraz  ->  jenm
wrc  ->  jep
wre  ->  jer
wren  ->  jera
wreon  ->  jerba
wrh  ->  jeu
wron  ->  jeba
wrong  ->  jebat
wrp  ->  jec
wrr  ->  jee
wrs  ->  jef
wrt  ->  jeg
wru  ->  jeh
wry  ->  jel
ws  ->  jf
wse  ->  jfr
wt  ->  jg
wta  ->  jgn
wtf  ->  jgs
wu  ->  jh
wub  ->  jho
wuba  ->  jhon
wuhan  ->  jhuna
wul  ->  jhy
wun  ->  jha
wurz  ->  jhem
wuz  ->  jhm
wv  ->  ji
wvh  ->  jiu
wvo  ->  jib
wvr  ->  jie
wvu  ->  jih
ww  ->  jj
www  ->  jjj
wx  ->  jk
wy  ->  jl
wyn  ->  jla
wyo  ->  jlb
wzf  ->  jms
x  ->  k
xa  ->  kn
xab  ->  kno
xabo  ->  knob
xabre  ->  knoer
xaf  ->  kns
xal  ->  kny
xala  ->  knyn
xali  ->  knyv
xals  ->  knyf
xan  ->  kna
xana  ->  knan
xanav  ->  knani
xano  ->  knab
xans  ->  knaf
xantre  ->  knager
xap  ->  knc
xar  ->  kne
xat  ->  kng
xav  ->  kni
xava  ->  knin
xave  ->  knir
xavi  ->  kniv
xavra  ->  knien
xax  ->  knk
xba  ->  kon
xban  ->  kona
xbb  ->  koo
xbc  ->  kop
xbl  ->  koy
xbla  ->  koyn
xbone  ->  kobar
xbt  ->  kog
xbx  ->  kok
xc  ->  kp
xcv  ->  kpi
xe  ->  kr
xebah  ->  kronu
xebat  ->  krong
xebb  ->  kroo
xebba  ->  kroon
xebbah  ->  kroonu
xebh  ->  krou
xec  ->  krp
xef  ->  krs
xeh  ->  kru
xel  ->  kry
xelan  ->  kryna
xelo  ->  kryb
xen  ->  kra
xena  ->  kran
xene  ->  krar
xeni  ->  krav
xeno  ->  krab
xenon  ->  kraba
xenu  ->  krah
xenyl  ->  kraly
xeo  ->  krb
xer  ->  kre
xera  ->  kren
xeraba  ->  krenon
xerar  ->  krene
xeri  ->  krev
xes  ->  krf
xevi  ->  kriv
xex  ->  krk
xf  ->  ks
xff  ->  kss
xfu  ->  ksh
xh  ->  ku
xham  ->  kunz
xhan  ->  kuna
xhcn  ->  kupa
xhe  ->  kur
xhel  ->  kury
xhep  ->  kurc
xhr  ->  kue
xi  ->  kv
xin  ->  kva
xina  ->  kvan
xine  ->  kvar
xing  ->  kvat
xinh  ->  kvau
xir  ->  kve
xira  ->  kven
xirara  ->  kvenen
xirei  ->  kverv
xis  ->  kvf
xiv  ->  kvi
xiva  ->  kvin
xix  ->  kvk
xiz  ->  kvm
xjo  ->  kwb
xk  ->  kx
xl  ->  ky
xla  ->  kyn
xlv  ->  kyi
xlvi  ->  kyiv
xm  ->  kz
xma  ->  kzn
xn  ->  ka
xna  ->  kan
xnand  ->  kanaq
xnor  ->  kabe
xnu  ->  kah
xo  ->  kb
xoa  ->  kbn
xoc  ->  kbp
xod  ->  kbq
xoe  ->  kbr
xof  ->  kbs
xon  ->  kba
xone  ->  kbar
xood  ->  kbbq
xop  ->  kbc
xor  ->  kbe
xou  ->  kbh
xove  ->  kbir
xoven  ->  kbira
xoz  ->  kbm
xp  ->  kc
xpa  ->  kcn
xpf  ->  kcs
xpo  ->  kcb
xq  ->  kd
xqs  ->  kdf
xr  ->  ke
xraf  ->  kens
xrara  ->  kenen
xrd  ->  keq
xrf  ->  kes
xrp  ->  kec
xrr  ->  kee
xs  ->  kf
xt  ->  kg
xtm  ->  kgz
xts  ->  kgf
xu  ->  kh
xuar  ->  khne
xuba  ->  khon
xuban  ->  khona
xue  ->  khr
xuf  ->  khs
xun  ->  kha
xung  ->  khat
xuns  ->  khaf
xur  ->  khe
xura  ->  khen
xurar  ->  khene
xure  ->  kher
xuru  ->  kheh
xuv  ->  khi
xv  ->  ki
xvi  ->  kiv
xvna  ->  kian
xw  ->  kj
xx  ->  kk
xxi  ->  kkv
xxo  ->  kkb
xxx  ->  kkk
xy  ->  kl
xya  ->  kln
xyl  ->  kly
xyls  ->  klyf
xyr  ->  kle
xyrs  ->  klef
xyz  ->  klm
y  ->  l
y'  ->  l'
'y  ->  'l
ya  ->  ln
yac  ->  lnp
yaf  ->  lns
yag  ->  lnt
yah  ->  lnu
yaje  ->  lnwr
yal  ->  lny
yan  ->  lna
yani  ->  lnav
yao  ->  lnb
yap  ->  lnc
yar  ->  lne
yare  ->  lner
yat  ->  lng
yau  ->  lnh
yb  ->  lo
yba  ->  lon
ybe  ->  lor
ybeen  ->  lorra
ybore  ->  lober
ybp  ->  loc
ybq  ->  lod
yburan  ->  lohena
yc  ->  lp
yce  ->  lpr
yd  ->  lq
ye  ->  lr
yea  ->  lrn
yean  ->  lrna
year  ->  lrne
yeb  ->  lro
yeg  ->  lrt
yen  ->  lra
yep  ->  lrc
yet  ->  lrg
yf  ->  ls
yg  ->  lt
ygy  ->  ltl
yh  ->  lu
yha  ->  lun
yhbt  ->  luog
yhe  ->  lur
yhi  ->  luv
yhm  ->  luz
yhu  ->  luh
yhwh  ->  luju
yhyy  ->  lull
yhz  ->  lum
yi  ->  lv
yif  ->  lvs
yig  ->  lvt
yin  ->  lva
yir  ->  lve
yiu  ->  lvh
yj  ->  lw
yje  ->  lwr
yk  ->  lx
ykk  ->  lxx
yl  ->  ly
yla  ->  lyn
ylar  ->  lyne
ylat  ->  lyng
yle  ->  lyr
ylen  ->  lyra
ylgr  ->  lyte
yli  ->  lyv
ylp  ->  lyc
ylr  ->  lye
yls  ->  lyf
ylur  ->  lyhe
ylw  ->  lyj
ylx  ->  lyk
ym  ->  lz
ymb  ->  lzo
yn  ->  la
yna  ->  lan
ynalh  ->  lanyu
ynch  ->  lapu
ynche  ->  lapur
yne  ->  lar
ynez  ->  larm
yng  ->  lat
ynga  ->  latn
ynge  ->  latr
yngla  ->  latyn
yngra  ->  laten
yngre  ->  later
yngt  ->  latg
yngva  ->  latin
yngvar  ->  latine
yngve  ->  latir
yngvi  ->  lativ
yni  ->  lav
ynk  ->  lax
ynn  ->  laa
ynne  ->  laar
yno  ->  lab
ynoh  ->  labu
ynone  ->  labar
ynta  ->  lagn
yo  ->  lb
yoa  ->  lbn
yob  ->  lbo
yoe  ->  lbr
yof  ->  lbs
yoi  ->  lbv
yol  ->  lby
yon  ->  lba
yoo  ->  lbb
yoq  ->  lbd
yos  ->  lbf
yow  ->  lbj
yox  ->  lbk
yoy  ->  lbl
yoz  ->  lbm
yp  ->  lc
ypg  ->  lct
ypp  ->  lcc
yppa  ->  lccn
yps  ->  lcf
yr  ->  le
yra  ->  len
yrak  ->  lenx
yrare  ->  lener
yrd  ->  leq
yre  ->  ler
yrk  ->  lex
yrn  ->  lea
yrnan  ->  leana
yrre  ->  leer
yrs  ->  lef
yrt  ->  leg
ys  ->  lf
ysaf  ->  lfns
ysg  ->  lft
ysi  ->  lfv
yso  ->  lfb
yst  ->  lfg
yt  ->  lg
yta  ->  lgn
yti  ->  lgv
ytp  ->  lgc
ytu  ->  lgh
yu  ->  lh
yuc  ->  lhp
yue  ->  lhr
yuf  ->  lhs
yuk  ->  lhx
yun  ->  lha
yunon  ->  lhaba
yup  ->  lhc
yur  ->  lhe
yuraq  ->  lhend
yure  ->  lher
yus  ->  lhf
yv  ->  li
yva  ->  lin
yvan  ->  lina
yvel  ->  liry
yver  ->  lire
yvfvn  ->  lisia
yvi  ->  liv
yvig  ->  livt
yvir  ->  live
yvo  ->  lib
yvon  ->  liba
yvor  ->  libe
yvore  ->  liber
yvory  ->  libel
yvre  ->  lier
yvyl  ->  lily
yvyra  ->  lilen
yvz  ->  lim
yw  ->  lj
ywb  ->  ljo
ywha  ->  ljun
yxan  ->  lkna
yy  ->  ll
yya  ->  lln
yyt  ->  llg
z  ->  m
z'  ->  m'
'z  ->  'm
za  ->  mn
zab  ->  mno
zac  ->  mnp
zaf  ->  mns
zag  ->  mnt
zah  ->  mnu
zaj  ->  mnw
zan  ->  mna
zap  ->  mnc
zapf  ->  mncs
zaq  ->  mnd
zar  ->  mne
zarar  ->  mnene
zare  ->  mner
zat  ->  mng
zau  ->  mnh
zaum  ->  mnhz
zav  ->  mni
zaw  ->  mnj
zaza  ->  mnmn
zb  ->  mo
zbar  ->  mone
zbat  ->  mong
zbath  ->  mongu
zbea  ->  morn
zbeh  ->  moru
zbej  ->  morw
zbib  ->  movo
zbir  ->  move
zbj  ->  mow
zbn  ->  moa
zbor  ->  mobe
zbq  ->  mod
zc  ->  mp
zcn  ->  mpa
zd  ->  mq
zde  ->  mqr
zdf  ->  mqs
ze  ->  mr
zean  ->  mrna
zeb  ->  mro
zeba  ->  mron
zec  ->  mrp
zeeg  ->  mrrt
zef  ->  mrs
zeg  ->  mrt
zeh  ->  mru
zei  ->  mrv
zein  ->  mrva
zeje  ->  mrwr
zel  ->  mry
zem  ->  mrz
zen  ->  mra
zena  ->  mran
zeni  ->  mrav
zenon  ->  mraba
zenz  ->  mram
zeo  ->  mrb
zep  ->  mrc
zepp  ->  mrcc
zer  ->  mre
zerava  ->  mrenin
zerf  ->  mres
zes  ->  mrf
zev  ->  mri
zew  ->  mrj
zey  ->  mrl
zez  ->  mrm
zf  ->  ms
zfc  ->  msp
zfn  ->  msa
zft  ->  msg
zg  ->  mt
zgeg  ->  mtrt
zgy  ->  mtl
zh  ->  mu
zha  ->  mun
zhah  ->  munu
zhan  ->  muna
zhang  ->  munat
zhapu  ->  munch
zhara  ->  munen
zhe  ->  mur
zhee  ->  murr
zheg  ->  murt
zheh  ->  muru
zhen  ->  mura
zheng  ->  murat
zhin  ->  muva
zhng  ->  muat
zhr  ->  mue
zhu  ->  muh
zhua  ->  muhn
zhug  ->  muht
zhun  ->  muha
zhuv  ->  muhi
zhyt  ->  mulg
zhz  ->  mum
zi  ->  mv
zic  ->  mvp
zici  ->  mvpv
zie  ->  mvr
zif  ->  mvs
zig  ->  mvt
zin  ->  mva
zio  ->  mvb
zip  ->  mvc
zipf  ->  mvcs
zipp  ->  mvcc
zise  ->  mvfr
zit  ->  mvg
ziu  ->  mvh
ziv  ->  mvi
zj  ->  mw
zje  ->  mwr
zjn  ->  mwa
zk  ->  mx
zl  ->  my
zla  ->  myn
zlagna  ->  myntan
zle  ->  myr
zll  ->  myy
zlr  ->  mye
zlu  ->  myh
zlx  ->  myk
zly  ->  myl
zm  ->  mz
zma  ->  mzn
z'n  ->  m'a
zn  ->  ma
zna  ->  man
znak  ->  manx
znal  ->  many
znam  ->  manz
znan  ->  mana
znana  ->  manan
znane  ->  manar
znani  ->  manav
znany  ->  manal
znat  ->  mang
znaty  ->  mangl
znb  ->  mao
zne  ->  mar
znej  ->  marw
znf  ->  mas
zni  ->  mav
znj  ->  maw
zno  ->  mab
znt  ->  mag
zo  ->  mb
zob  ->  mbo
zobat  ->  mbong
zoe  ->  mbr
zog  ->  mbt
zoh  ->  mbu
zohy  ->  mbul
zoin  ->  mbva
zoja  ->  mbwn
zol  ->  mby
zon  ->  mba
zona  ->  mban
zond  ->  mbaq
zone  ->  mbar
zong  ->  mbat
zonne  ->  mbaar
zonnen  ->  mbaara
zoof  ->  mbbs
zop  ->  mbc
zopf  ->  mbcs
zoq  ->  mbd
zor  ->  mbe
zorg  ->  mbet
zorna  ->  mbean
zoru  ->  mbeh
zou  ->  mbh
zov  ->  mbi
zova  ->  mbin
zoy  ->  mbl
zoz  ->  mbm
zp  ->  mc
zpg  ->  mct
zps  ->  mcf
zpt  ->  mcg
zr  ->  me
zra  ->  men
zre  ->  mer
zree  ->  merr
zrel  ->  mery
zrn  ->  mea
zrna  ->  mean
zrnat  ->  meang
zryw  ->  melj
zs  ->  mf
zsu  ->  mfh
zsv  ->  mfi
zt  ->  mg
zu  ->  mh
zua  ->  mhn
zub  ->  mho
zuby  ->  mhol
zuc  ->  mhp
zuj  ->  mhw
zum  ->  mhz
zun  ->  mha
zunn  ->  mhaa
zup  ->  mhc
zupf  ->  mhcs
zura  ->  mhen
zut  ->  mhg
zuu  ->  mhh
zuw  ->  mhj
zuz  ->  mhm
zv  ->  mi
zvara  ->  minen
zver  ->  mire
zverk  ->  mirex
zvgu  ->  mith
zw  ->  mj
zwa  ->  mjn
zwb  ->  mjo
zwe  ->  mjr
zwj  ->  mjw
zwn  ->  mja
zwr  ->  mje
zy  ->  ml
zyba  ->  mlon
zyc  ->  mlp
zyh  ->  mlu
zyla  ->  mlyn
zyn  ->  mla
zyva  ->  mlin
zyx  ->  mlk
zz  ->  mm
zza  ->  mmn
zzo  ->  mmb
zzz  ->  mmm
zzzz  ->  mmmm
zzzzzz  ->  mmmmmm
